Anio,Country ID,Country,Trade Value Export,Trade Value Import,Trade Value Delta,ISO 3
2020,ago,Angola,89352,3911,85441,AGO
2020,bfa,Burkina Faso,51080,715,50365,BFA
2020,caf,República Centroafricana,0,20,-20,CAF
2020,civ,Côte d'Ivoire,2953681,52266,2901415,CIV
2020,cmr,Camerún,152062,23,152039,CMR
2020,cog,"Congo, República del",0,67,-67,COG
2020,com,Comoras,0,161,-161,COM
2020,egy,Egipto,1353851,49341,1304510,EGY
2020,eri,Eritrea,0,1428,-1428,ERI
2020,esh,Sahara Occidental,0,11565,-11565,ESH
2020,gab,Gabón,21939,151,21788,GAB
2020,gha,Ghana,3516787,13,3516774,GHA
2020,gin,Guinea,118063,80,117983,GIN
2020,gmb,Gambia,0,659,-659,GMB
2020,mar,Marruecos,2532948,348243,2184705,MAR
2020,mdg,Madagascar,200408,668,199740,MDG
2020,mrt,Mauritania,0,279,-279,MRT
2020,mwi,Malawi,0,753,-753,MWI
2020,myt,Mayotte,0,25,-25,MYT
2020,nam,Namibia,634206,726,633480,NAM
2020,nga,Nigeria,4893875,43787,4850088,NGA
2020,reu,Réunion,0,13800,-13800,REU
2020,sen,Senegal,831432,376,831056,SEN
2020,sle,Sierra Leona,12000,4460,7540,SLE
2020,som,Somalia,0,632,-632,SOM
2020,swz,Esuatini,288775,35963,252812,SWZ
2020,syc,Seychelles,0,66451,-66451,SYC
2020,tcd,Chad,0,14,-14,TCD
2020,tun,Túnez,633172,370211,262961,TUN
2020,tza,Tanzania,250000,565,249435,TZA
2020,uga,Uganda,58681,15652,43029,UGA
2020,zaf,Sudáfrica,48133566,72360201,-24226635,ZAF
2020,ata,Antártida,0,401,-401,ATA
2020,afg,Afganistán,0,13959,-13959,AFG
2020,are,Emiratos Árabes Unidos,165130748,1811057,163319691,ARE
2020,bgd,Bangladesh,137432,21697,115735,BGD
2020,brn,Brunéi,2372630,210,2372420,BRN
2020,btn,Bhutan,0,3823,-3823,BTN
2020,chn,China,1180079840,3055337369,-1875257529,CHN
2020,cyp,Chipre,1826925,755,1826170,CYP
2020,geo,Georgia,206800,241,206559,GEO
2020,hkg,Hong Kong,79076779,2111905,76964874,HKG
2020,idn,Indonesia,7038694,163683964,-156645270,IDN
2020,ind,India,16105106,1274217304,-1258112198,IND
2020,iot,Territorio Británico del Océano Índico,0,39,-39,IOT
2020,irn,Irán,227594,6,227588,IRN
2020,isr,Israel,71773754,677397,71096357,ISR
2020,jor,Jordania,1931426,60567,1870859,JOR
2020,jpn,Japón,621474121,2851178443,-2229704322,JPN
2020,khm,Camboya,4432168,1080454,3351714,KHM
2020,kor,Corea del Sur,853040203,1294135151,-441094948,KOR
2020,lka,Sri Lanka,1425945,234068,1191877,LKA
2020,mac,Macau,1800,178373,-176573,MAC
2020,mmr,Birmania,2072658,1628,2071030,MMR
2020,mng,Mongolia,509648,53,509595,MNG
2020,mys,Malasia,15063296,15390458,-327162,MYS
2020,npl,Nepal,219118,107,219011,NPL
2020,omn,Omán,18386557,3686193,14700364,OMN
2020,pak,Pakistán,208229,63656,144573,PAK
2020,phl,Filipinas,4083950,7536519,-3452569,PHL
2020,qat,Katar,34437859,299,34437560,QAT
2020,sau,Arabia Saudita,131746693,6867,131739826,SAU
2020,sgp,Singapur,19995214,9895787,10099427,SGP
2020,syr,Siria,0,13,-13,SYR
2020,tha,Tailandia,77813554,523846425,-446032871,THA
2020,tjk,Tayikistán,0,394,-394,TJK
2020,tkm,Turkmenistán,0,250,-250,TKM
2020,tur,Turquía,3719649,160512229,-156792580,TUR
2020,twn,Taiwan,123467303,152347047,-28879744,TWN
2020,uzb,Uzbekistán,1892950,176286,1716664,UZB
2020,vnm,Vietnam,13428695,94635145,-81206450,VNM
2020,yem,Yemen,43852,7196,36656,YEM
2020,alb,Albania,0,8273,-8273,ALB
2020,ant,Antillas Holandesas,1159356,127,1159229,ANT
2020,aut,Austria,89107962,177356837,-88248875,AUT
2020,bel,Bélgica,198543339,43376783,155166556,BEL
2020,bgr,Bulgaria,6109,1620893,-1614784,BGR
2020,bih,Bosnia y Herzegovina,0,8340570,-8340570,BIH
2020,che,Suiza,68725589,24581488,44144101,CHE
2020,cze,Chequia,12030725,162855650,-150824925,CZE
2020,deu,Alemania,4563868567,2139967832,2423900735,DEU
2020,dnk,Dinamarca,42608846,4432996,38175850,DNK
2020,emu,Comunidad Europea,0,1130230,-1130230,EMU
2020,esp,España,116413807,318123542,-201709735,ESP
2020,est,Estonia,1121859,16536613,-15414754,EST
2020,fin,Finlandia,69873650,4523610,65350040,FIN
2020,fra,Francia,87957645,198989566,-111031921,FRA
2020,fro,Islas Feroe,0,758,-758,FRO
2020,gbr,Reino Unido,226877183,110402781,116474402,GBR
2020,grc,Grecia,149056,96582,52474,GRC
2020,hrv,Croacia,4983694,2001103,2982591,HRV
2020,hun,Hungría,10792880,254575244,-243782364,HUN
2020,irl,Irlanda,180566,67369,113197,IRL
2020,isl,Islandia,2160838,33375,2127463,ISL
2020,ita,Italia,399126847,413636254,-14509407,ITA
2020,lie,Liechtenstein,1807143,5029575,-3222432,LIE
2020,ltu,Lituania,426276,888381,-462105,LTU
2020,lux,Luxemburgo,866287,190349,675938,LUX
2020,lva,Letonia,1482206,34822,1447384,LVA
2020,mco,Mónaco,0,6403,-6403,MCO
2020,mkd,Macedonia del Norte,133836,4349647,-4215811,MKD
2020,mlt,Malta,3233,89,3144,MLT
2020,mne,Montenegro,0,77,-77,MNE
2020,nld,Países Bajos,46680477,73540856,-26860379,NLD
2020,nor,Noruega,5868598,7910828,-2042230,NOR
2020,pol,Polonia,57849154,181826140,-123976986,POL
2020,prt,Portugal,10135603,32733406,-22597803,PRT
2020,rou,Rumania,14489879,144498284,-130008405,ROU
2020,rus,Rusia,212291995,883879,211408116,RUS
2020,smr,San Marino,0,777,-777,SMR
2020,srb,Serbia,756561,924933,-168372,SRB
2020,svk,Eslovaquia,5506111,153582401,-148076290,SVK
2020,svn,Eslovenia,5725557,4024793,1700764,SVN
2020,swe,Suecia,6688454,98695430,-92006976,SWE
2020,ukr,Ucrania,7483499,218100,7265399,UKR
2020,abw,Aruba,3298792,5387,3293405,ABW
2020,aia,Anguilla,0,2761,-2761,AIA
2020,atg,Antigua y Barbuda,4240,361,3879,ATG
2020,bhs,Las Bahamas,3207470,41,3207429,BHS
2020,blz,Belice,1862936,5423,1857513,BLZ
2020,can,Canadá,4165090655,1304632918,2860457737,CAN
2020,cri,Costa Rica,44792353,3156647,41635706,CRI
2020,cuw,Curaçao,3464766,48976,3415790,CUW
2020,dma,Dominica,13784352,75,13784277,DMA
2020,dom,República Dominicana,16519979,864487,15655492,DOM
2020,gtm,Guatemala,52125446,125837,51999609,GTM
2020,hnd,Honduras,40359221,12805544,27553677,HND
2020,hti,Haití,3045281,8761,3036520,HTI
2020,jam,Jamaica,4770461,132,4770329,JAM
2020,msr,Montserrat,14056,832,13224,MSR
2020,nic,Nicaragua,13116183,16,13116167,NIC
2020,pan,Panamá,43245198,45197,43200001,PAN
2020,pri,Puerto Rico,176635507,777090,175858417,PRI
2020,slv,El Salvador,33372678,3812,33368866,SLV
2020,tto,Trinidad y Tobago,4820580,3719,4816861,TTO
2020,usa,Estados Unidos,83363951837,15089497143,68274454694,USA
2020,vgb,Islas Vírgenes Británicas,164915,22635115,-22470200,VGB
2020,vir,Islas Vírgenes,0,449,-449,VIR
2020,pcz,Zona del Canal de Panamá,0,248,-248,PCZ
2020,asm,Samoa Americana,0,104945,-104945,ASM
2020,aus,Australia,412359411,6848032,405511379,AUS
2020,cok,Islas Cook,0,105,-105,COK
2020,fsm,Micronesia,6410,17,6393,FSM
2020,kir,Kiribati,0,126,-126,KIR
2020,mnp,Islas Marianas del Norte,0,399,-399,MNP
2020,ncl,Nueva Caledonia,334605,495,334110,NCL
2020,nzl,Nueva Zelandia,35771900,49663,35722237,NZL
2020,pcn,Islas Pitcairn,0,82,-82,PCN
2020,plw,Palau,0,1696,-1696,PLW
2020,tkl,Tokelau,0,1151,-1151,TKL
2020,wsm,Samoa,0,22111,-22111,WSM
2020,arg,Argentina,195268255,66509779,128758476,ARG
2020,bol,Bolivia,23045600,603,23044997,BOL
2020,bra,Brasil,903774480,719359770,184414710,BRA
2020,chl,Chile,246805978,1940367,244865611,CHL
2020,col,Colombia,625358432,54501089,570857343,COL
2020,ecu,Ecuador,79898367,2808,79895559,ECU
2020,per,Perú,130816280,874931,129941349,PER
2020,sur,Suriname,520683,7292,513391,SUR
2020,ury,Uruguay,52783064,251207,52531857,URY
2020,ven,Venezuela,14998131,71699,14926432,VEN
2020,ben,Benin,149932,0,149932,BEN
2020,bwa,Botswana,91708,0,91708,BWA
2020,dji,Djibouti,174424,0,174424,DJI
2020,dza,Argelia,6252318,0,6252318,DZA
2020,eth,Etiopía,1621416,0,1621416,ETH
2020,ken,Kenia,2257795,0,2257795,KEN
2020,lby,Libia,555091,0,555091,LBY
2020,mli,Malí,957795,0,957795,MLI
2020,mus,Mauricio,1085148,0,1085148,MUS
2020,ner,Níger,71999,0,71999,NER
2020,rwa,Ruanda,61769,0,61769,RWA
2020,zmb,Zambia,465187,0,465187,ZMB
2020,zwe,Zimbabue,745234,0,745234,ZWE
2020,arm,Armenia,146805,0,146805,ARM
2020,aze,Azerbaiyán,4229365,0,4229365,AZE
2020,bhr,Bahrein,3675034,0,3675034,BHR
2020,cxr,Isla de Navidad,34546,0,34546,CXR
2020,irq,Irak,240366,0,240366,IRQ
2020,kaz,Kazajstán,80770,0,80770,KAZ
2020,kgz,Kirguistán,444520,0,444520,KGZ
2020,kwt,Kuwait,61556192,0,61556192,KWT
2020,lao,Laos,695122,0,695122,LAO
2020,lbn,Líbano,1562003,0,1562003,LBN
2020,pse,Palestina,141904,0,141904,PSE
2020,blr,Bielorrusia,163577,0,163577,BLR
2020,mda,Moldavia,31601,0,31601,MDA
2020,blm,San Bartolomé,32815,0,32815,BLM
2020,brb,Barbados,1531719,0,1531719,BRB
2020,cub,Cuba,723410,0,723410,CUB
2020,cym,Islas Caimán,1124727,0,1124727,CYM
2020,grd,Granada,93260,0,93260,GRD
2020,kna,Saint Kitts y Nevis,22646,0,22646,KNA
2020,lca,Santa Lucía,23890,0,23890,LCA
2020,maf,San Martín,2915190,0,2915190,MAF
2020,tca,Turcas y Caicos,369231,0,369231,TCA
2020,glp,Guadalupe,520946,0,520946,GLP
2020,mtq,Martinica,556101,0,556101,MTQ
2020,sxm,San Martín,1020460,0,1020460,SXM
2020,gum,Guam,902225,0,902225,GUM
2020,pyf,Polinesia francés,214265,0,214265,PYF
2020,tuv,Tuvalu,809,0,809,TUV
2020,guy,Guayana,1049564,0,1049564,GUY
2020,pry,Paraguay,28000172,0,28000172,PRY
2020,guf,Guayana Francesa,9,0,9,GUF
2019,ago,Angola,519580,3339457,-2819877,AGO
2019,ben,Benin,0,12,-12,BEN
2019,bfa,Burkina Faso,40752,7,40745,BFA
2019,caf,República Centroafricana,0,1650,-1650,CAF
2019,cmr,Camerún,52044,16405,35639,CMR
2019,cog,"Congo, República del",0,205,-205,COG
2019,egy,Egipto,2208533,23897,2184636,EGY
2019,esh,Sahara Occidental,9366,4223,5143,ESH
2019,gab,Gabón,140286,759,139527,GAB
2019,gmb,Gambia,0,922,-922,GMB
2019,ken,Kenia,271950,227910,44040,KEN
2019,mar,Marruecos,3741482,277050,3464432,MAR
2019,mrt,Mauritania,0,28,-28,MRT
2019,mus,Mauricio,1652113,75904,1576209,MUS
2019,nam,Namibia,304816,523,304293,NAM
2019,reu,Réunion,0,1559,-1559,REU
2019,rwa,Ruanda,0,44,-44,RWA
2019,sdn,Sudán,681430,869,680561,SDN
2019,sen,Senegal,358073,7433,350640,SEN
2019,shn,Santa Elena,0,789,-789,SHN
2019,sle,Sierra Leona,0,4975,-4975,SLE
2019,som,Somalia,199900,58,199842,SOM
2019,swz,Esuatini,279140,2578,276562,SWZ
2019,syc,Seychelles,112074,463317,-351243,SYC
2019,tcd,Chad,0,420,-420,TCD
2019,tun,Túnez,3855725,249112,3606613,TUN
2019,tza,Tanzania,85990,44,85946,TZA
2019,uga,Uganda,86395,5946,80449,UGA
2019,zaf,Sudáfrica,96261216,80197660,16063556,ZAF
2019,zwe,Zimbabue,1085306,632,1084674,ZWE
2019,atf,Francés Territorio Sur de la Antártida,0,78,-78,ATF
2019,afg,Afganistán,3759,11344,-7585,AFG
2019,are,Emiratos Árabes Unidos,135618061,3654893,131963168,ARE
2019,arm,Armenia,1305535,26,1305509,ARM
2019,bgd,Bangladesh,0,28381,-28381,BGD
2019,chn,China,1283300320,4069891577,-2786591257,CHN
2019,cyp,Chipre,3243441,221,3243220,CYP
2019,geo,Georgia,318814,804,318010,GEO
2019,hkg,Hong Kong,59473714,1577341,57896373,HKG
2019,idn,Indonesia,7434225,152323327,-144889102,IDN
2019,ind,India,115687507,1648956048,-1533268541,IND
2019,isr,Israel,88776690,1603685,87173005,ISR
2019,jor,Jordania,5168221,23620,5144601,JOR
2019,jpn,Japón,631884052,3561349593,-2929465541,JPN
2019,kaz,Kazajstán,605209,6655,598554,KAZ
2019,kgz,Kirguistán,0,13950,-13950,KGZ
2019,khm,Camboya,13654427,732791,12921636,KHM
2019,kor,Corea del Sur,340934547,1808310650,-1467376103,KOR
2019,lao,Laos,610215,255,609960,LAO
2019,lbn,Líbano,16468595,20,16468575,LBN
2019,lka,Sri Lanka,6724,202404,-195680,LKA
2019,mac,Macau,0,53071,-53071,MAC
2019,mdv,Maldivas,0,1440,-1440,MDV
2019,mmr,Birmania,463201,10027,453174,MMR
2019,mng,Mongolia,763078,40,763038,MNG
2019,mys,Malasia,35829742,11518733,24311009,MYS
2019,npl,Nepal,109126,488,108638,NPL
2019,omn,Omán,20715165,4891785,15823380,OMN
2019,pak,Pakistán,95794,31896,63898,PAK
2019,phl,Filipinas,3406262,11227616,-7821354,PHL
2019,pse,Palestina,1304850,226,1304624,PSE
2019,qat,Katar,30998669,2475,30996194,QAT
2019,sau,Arabia Saudita,119087740,102566,118985174,SAU
2019,sgp,Singapur,20934849,13436954,7497895,SGP
2019,tha,Tailandia,148165385,923443645,-775278260,THA
2019,tkm,Turkmenistán,29457,41,29416,TKM
2019,tmp,Timor Oriental,0,549,-549,TMP
2019,tur,Turquía,10968301,187086692,-176118391,TUR
2019,twn,Taiwan,144629164,176085642,-31456478,TWN
2019,vnm,Vietnam,17084817,117253538,-100168721,VNM
2019,alb,Albania,310705,9391,301314,ALB
2019,and,Andorra,0,2145,-2145,AND
2019,ant,Antillas Holandesas,1762703,20,1762683,ANT
2019,aut,Austria,64750608,230757209,-166006601,AUT
2019,bel,Bélgica,232369855,52608327,179761528,BEL
2019,bgr,Bulgaria,4475216,3258776,1216440,BGR
2019,bih,Bosnia y Herzegovina,0,10445975,-10445975,BIH
2019,blr,Bielorrusia,380837,126,380711,BLR
2019,che,Suiza,67732037,38339894,29392143,CHE
2019,cze,Chequia,6795809,266202533,-259406724,CZE
2019,deu,Alemania,4758825398,3397479478,1361345920,DEU
2019,dnk,Dinamarca,15715994,4226671,11489323,DNK
2019,emu,Comunidad Europea,0,676462,-676462,EMU
2019,esp,España,186937191,454830436,-267893245,ESP
2019,est,Estonia,877749,18013210,-17135461,EST
2019,fin,Finlandia,114617204,15870507,98746697,FIN
2019,fra,Francia,97357883,272570127,-175212244,FRA
2019,gbr,Reino Unido,181260332,221830687,-40570355,GBR
2019,grc,Grecia,2298827,303038,1995789,GRC
2019,hrv,Croacia,3691531,3351246,340285,HRV
2019,hun,Hungría,40539511,326678993,-286139482,HUN
2019,imn,Isla de Man,0,234,-234,IMN
2019,irl,Irlanda,176062,53171,122891,IRL
2019,isl,Islandia,5242904,5811,5237093,ISL
2019,ita,Italia,708872376,588758157,120114219,ITA
2019,lie,Liechtenstein,1856865,293709,1563156,LIE
2019,ltu,Lituania,21039872,133227,20906645,LTU
2019,lux,Luxemburgo,3747278,1152524,2594754,LUX
2019,lva,Letonia,126502,51471,75031,LVA
2019,mco,Mónaco,0,6007,-6007,MCO
2019,mda,Moldavia,1846,115,1731,MDA
2019,mkd,Macedonia del Norte,453547,6427319,-5973772,MKD
2019,mlt,Malta,6839,1273,5566,MLT
2019,mne,Montenegro,0,12,-12,MNE
2019,nld,Países Bajos,58136205,117702886,-59566681,NLD
2019,nor,Noruega,5595251,7109334,-1514083,NOR
2019,pol,Polonia,66519605,212496453,-145976848,POL
2019,prt,Portugal,16930684,22565255,-5634571,PRT
2019,rou,Rumania,42664398,99836728,-57172330,ROU
2019,rus,Rusia,153770178,381042,153389136,RUS
2019,sjm,Svalbard y Jan Mayen,0,157,-157,SJM
2019,smr,San Marino,0,128,-128,SMR
2019,srb,Serbia,1544301,565087,979214,SRB
2019,svk,Eslovaquia,3552494,292756280,-289203786,SVK
2019,svn,Eslovenia,3618741,5509087,-1890346,SVN
2019,swe,Suecia,11499398,177556064,-166056666,SWE
2019,ukr,Ucrania,7190760,125725,7065035,UKR
2019,yug,Yugoslavia,0,3526,-3526,YUG
2019,abw,Aruba,6735595,38679,6696916,ABW
2019,aia,Anguilla,2615,2053,562,AIA
2019,atg,Antigua y Barbuda,34112,9737,24375,ATG
2019,blz,Belice,2926498,556,2925942,BLZ
2019,can,Canadá,5505638340,1531781010,3973857330,CAN
2019,cri,Costa Rica,48783283,4173205,44610078,CRI
2019,cub,Cuba,1346431,1358,1345073,CUB
2019,cuw,Curaçao,5725020,125469,5599551,CUW
2019,cym,Islas Caimán,599994,33,599961,CYM
2019,dom,República Dominicana,30926666,351067,30575599,DOM
2019,grd,Granada,14076,21,14055,GRD
2019,gtm,Guatemala,68396332,787288,67609044,GTM
2019,hnd,Honduras,62159085,13730518,48428567,HND
2019,hti,Haití,5837174,11859,5825315,HTI
2019,jam,Jamaica,7315802,944,7314858,JAM
2019,kna,Saint Kitts y Nevis,152427,313,152114,KNA
2019,maf,San Martín,7054321,63,7054258,MAF
2019,nic,Nicaragua,9488414,190,9488224,NIC
2019,pan,Panamá,136727181,109462,136617719,PAN
2019,pri,Puerto Rico,323534698,1714585,321820113,PRI
2019,slv,El Salvador,48270049,1903,48268146,SLV
2019,spm,San Pedro y Miquelón,0,377,-377,SPM
2019,tca,Turcas y Caicos,690285,291,689994,TCA
2019,tto,Trinidad y Tobago,3978775,2181,3976594,TTO
2019,usa,Estados Unidos,1.00E+11,19756473032,80496901400,USA
2019,vct,San Vicente y las Granadinas,0,34,-34,VCT
2019,vgb,Islas Vírgenes Británicas,170524,13597779,-13427255,VGB
2019,vir,Islas Vírgenes,0,128,-128,VIR
2019,pcz,Zona del Canal de Panamá,0,5584,-5584,PCZ
2019,sxm,San Martín,1221647,227,1221420,SXM
2019,aus,Australia,433795748,6374493,427421255,AUS
2019,cok,Islas Cook,0,22580,-22580,COK
2019,mhl,Islas Marshall,1284861,54,1284807,MHL
2019,mnp,Islas Marianas del Norte,0,27,-27,MNP
2019,ncl,Nueva Caledonia,803376,710,802666,NCL
2019,niu,Niue,0,190,-190,NIU
2019,nzl,Nueva Zelandia,57037134,188436,56848698,NZL
2019,plw,Palau,0,26108,-26108,PLW
2019,pyf,Polinesia francés,603736,22,603714,PYF
2019,slb,Islas Salomón,0,38,-38,SLB
2019,tkl,Tokelau,0,3487,-3487,TKL
2019,tuv,Tuvalu,0,103,-103,TUV
2019,arg,Argentina,156886846,124576142,32310704,ARG
2019,bra,Brasil,1793930418,839150912,954779506,BRA
2019,chl,Chile,410438319,2290716,408147603,CHL
2019,col,Colombia,859890887,110124367,749766520,COL
2019,ecu,Ecuador,167342227,918,167341309,ECU
2019,per,Perú,242085197,818559,241266638,PER
2019,sur,Suriname,297843,1812,296031,SUR
2019,ury,Uruguay,45096467,190660,44905807,URY
2019,ven,Venezuela,3333770,358839,2974931,VEN
2019,bwa,Botswana,255407,0,255407,BWA
2019,civ,Côte d'Ivoire,3114451,0,3114451,CIV
2019,dji,Djibouti,51160,0,51160,DJI
2019,dza,Argelia,37437071,0,37437071,DZA
2019,eth,Etiopía,912682,0,912682,ETH
2019,gha,Ghana,289787,0,289787,GHA
2019,gin,Guinea,82287,0,82287,GIN
2019,lbr,Liberia,223627,0,223627,LBR
2019,lby,Libia,73538,0,73538,LBY
2019,mdg,Madagascar,245250,0,245250,MDG
2019,mli,Malí,450890,0,450890,MLI
2019,nga,Nigeria,11083273,0,11083273,NGA
2019,ssd,Sudán del Sur,280962,0,280962,SSD
2019,zmb,Zambia,200170,0,200170,ZMB
2019,aze,Azerbaiyán,4133315,0,4133315,AZE
2019,bhr,Bahrein,7538585,0,7538585,BHR
2019,brn,Brunéi,6752282,0,6752282,BRN
2019,irq,Irak,291046,0,291046,IRQ
2019,kwt,Kuwait,67719312,0,67719312,KWT
2019,uzb,Uzbekistán,1100734,0,1100734,UZB
2019,bes,Bonaire,142981,0,142981,BES
2019,bhs,Las Bahamas,4266764,0,4266764,BHS
2019,bmu,Bermuda,5475,0,5475,BMU
2019,brb,Barbados,2161485,0,2161485,BRB
2019,dma,Dominica,28195947,0,28195947,DMA
2019,lca,Santa Lucía,167474,0,167474,LCA
2019,glp,Guadalupe,2218643,0,2218643,GLP
2019,mtq,Martinica,1991349,0,1991349,MTQ
2019,asm,Samoa Americana,366,0,366,ASM
2019,fji,Fiji,687546,0,687546,FJI
2019,fsm,Micronesia,20191,0,20191,FSM
2019,gum,Guam,241345,0,241345,GUM
2019,wsm,Samoa,11220,0,11220,WSM
2019,bol,Bolivia,48768356,0,48768356,BOL
2019,guy,Guayana,1290719,0,1290719,GUY
2019,pry,Paraguay,35750583,0,35750583,PRY
2019,guf,Guayana Francesa,343230,0,343230,GUF
2018,bdi,Burundi,0,240,-240,BDI
2018,bfa,Burkina Faso,776941,417,776524,BFA
2018,caf,República Centroafricana,34452,219,34233,CAF
2018,civ,Côte d'Ivoire,3217198,226,3216972,CIV
2018,cmr,Camerún,0,321,-321,CMR
2018,cod,"Congo, República Democrática del",0,1719,-1719,COD
2018,egy,Egipto,15612875,21536,15591339,EGY
2018,eri,Eritrea,0,1426,-1426,ERI
2018,esh,Sahara Occidental,0,390,-390,ESH
2018,gab,Gabón,0,197,-197,GAB
2018,gha,Ghana,1966013,675,1965338,GHA
2018,gin,Guinea,0,2148,-2148,GIN
2018,gmb,Gambia,20376,1604,18772,GMB
2018,ken,Kenia,353502,209885,143617,KEN
2018,lby,Libia,22078,5,22073,LBY
2018,mar,Marruecos,7052059,95038,6957021,MAR
2018,mdg,Madagascar,240148,10,240138,MDG
2018,moz,Mozambique,1713184,83,1713101,MOZ
2018,mwi,Malawi,0,122,-122,MWI
2018,reu,Réunion,3473099,90,3473009,REU
2018,sen,Senegal,318180,5219,312961,SEN
2018,sle,Sierra Leona,0,988948,-988948,SLE
2018,swz,Esuatini,192127,1519,190608,SWZ
2018,syc,Seychelles,0,69914,-69914,SYC
2018,tcd,Chad,0,449,-449,TCD
2018,tun,Túnez,2633473,125077,2508396,TUN
2018,tza,Tanzania,358572,1118,357454,TZA
2018,uga,Uganda,33339,6668,26671,UGA
2018,zaf,Sudáfrica,48706766,41111622,7595144,ZAF
2018,zmb,Zambia,381624,62,381562,ZMB
2018,zwe,Zimbabue,312097,150,311947,ZWE
2018,atf,Francés Territorio Sur de la Antártida,0,265,-265,ATF
2018,afg,Afganistán,0,34784,-34784,AFG
2018,are,Emiratos Árabes Unidos,107312599,2812125,104500474,ARE
2018,arm,Armenia,1151783,12,1151771,ARM
2018,bgd,Bangladesh,0,4854,-4854,BGD
2018,brn,Brunéi,7659401,337,7659064,BRN
2018,chn,China,1511395225,3833701065,-2322305840,CHN
2018,cyp,Chipre,3761000,6217,3754783,CYP
2018,geo,Georgia,0,6632,-6632,GEO
2018,hkg,Hong Kong,61594141,1310726,60283415,HKG
2018,idn,Indonesia,16946265,114189259,-97242994,IDN
2018,ind,India,110389759,1716482436,-1606092677,IND
2018,iot,Territorio Británico del Océano Índico,0,14,-14,IOT
2018,irn,Irán,236380,77826,158554,IRN
2018,irq,Irak,2013306,22,2013284,IRQ
2018,isr,Israel,91789416,3325614,88463802,ISR
2018,jor,Jordania,5228803,19729,5209074,JOR
2018,jpn,Japón,532703450,3594215882,-3061512432,JPN
2018,khm,Camboya,3384241,1055398,2328843,KHM
2018,kor,Corea del Sur,344575284,1892672466,-1548097182,KOR
2018,lbn,Líbano,25193755,20,25193735,LBN
2018,lka,Sri Lanka,70388,353506,-283118,LKA
2018,mac,Macau,367333,76,367257,MAC
2018,mmr,Birmania,0,3438,-3438,MMR
2018,mng,Mongolia,488949,9,488940,MNG
2018,mys,Malasia,12608010,14002546,-1394536,MYS
2018,npl,Nepal,0,3253,-3253,NPL
2018,omn,Omán,16056970,7561024,8495946,OMN
2018,pak,Pakistán,94006,106035,-12029,PAK
2018,phl,Filipinas,916447,11799091,-10882644,PHL
2018,qat,Katar,9139324,24875,9114449,QAT
2018,sau,Arabia Saudita,56166737,16259,56150478,SAU
2018,sgp,Singapur,10325998,13376639,-3050641,SGP
2018,syr,Siria,0,465,-465,SYR
2018,tha,Tailandia,146763793,970880165,-824116372,THA
2018,tkm,Turkmenistán,0,2537,-2537,TKM
2018,tur,Turquía,32829540,224391471,-191561931,TUR
2018,twn,Taiwan,64732349,188320166,-123587817,TWN
2018,uzb,Uzbekistán,854128,20195,833933,UZB
2018,vnm,Vietnam,26397161,88832770,-62435609,VNM
2018,yem,Yemen,62198,22713,39485,YEM
2018,alb,Albania,0,4569,-4569,ALB
2018,and,Andorra,0,59982,-59982,AND
2018,ant,Antillas Holandesas,1929789,8,1929781,ANT
2018,aut,Austria,112770969,231959610,-119188641,AUT
2018,bel,Bélgica,354597545,35716101,318881444,BEL
2018,bgr,Bulgaria,672652,3178521,-2505869,BGR
2018,bih,Bosnia y Herzegovina,0,9588137,-9588137,BIH
2018,blr,Bielorrusia,0,7456,-7456,BLR
2018,che,Suiza,85649997,44560056,41089941,CHE
2018,cze,Chequia,12687924,329233253,-316545329,CZE
2018,deu,Alemania,4393285771,3152644156,1240641615,DEU
2018,dnk,Dinamarca,29873678,4819050,25054628,DNK
2018,emu,Comunidad Europea,270743,206099,64644,EMU
2018,esp,España,341327719,581586862,-240259143,ESP
2018,est,Estonia,4691396,13322152,-8630756,EST
2018,fin,Finlandia,90290220,23372188,66918032,FIN
2018,fra,Francia,150790401,287738058,-136947657,FRA
2018,gbr,Reino Unido,221109210,248679589,-27570379,GBR
2018,grc,Grecia,10017368,198428,9818940,GRC
2018,hrv,Croacia,10372063,3040068,7331995,HRV
2018,hun,Hungría,36900812,277793380,-240892568,HUN
2018,irl,Irlanda,2727022,141272,2585750,IRL
2018,isl,Islandia,3627558,6844,3620714,ISL
2018,ita,Italia,992204903,583639073,408565830,ITA
2018,lie,Liechtenstein,1778921,144549,1634372,LIE
2018,ltu,Lituania,2137368,146255,1991113,LTU
2018,lux,Luxemburgo,60884,5833549,-5772665,LUX
2018,lva,Letonia,0,69840,-69840,LVA
2018,mco,Mónaco,0,1496,-1496,MCO
2018,mda,Moldavia,2925,71,2854,MDA
2018,mkd,Macedonia del Norte,339980,7706613,-7366633,MKD
2018,mlt,Malta,98884,524,98360,MLT
2018,mne,Montenegro,0,18,-18,MNE
2018,nld,Países Bajos,71788499,98807388,-27018889,NLD
2018,nor,Noruega,5603678,7607722,-2004044,NOR
2018,pol,Polonia,77383856,180004032,-102620176,POL
2018,prt,Portugal,28403433,39311996,-10908563,PRT
2018,rou,Rumania,52651965,64625316,-11973351,ROU
2018,rus,Rusia,124252737,1247508,123005229,RUS
2018,smr,San Marino,0,610,-610,SMR
2018,srb,Serbia,2690674,3113121,-422447,SRB
2018,svk,Eslovaquia,8340578,222283912,-213943334,SVK
2018,svn,Eslovenia,8433158,4892768,3540390,SVN
2018,swe,Suecia,18008468,141482574,-123474106,SWE
2018,ukr,Ucrania,6548601,83357,6465244,UKR
2018,vat,Ciudad del Vaticano,0,45,-45,VAT
2018,abw,Aruba,11187809,241651,10946158,ABW
2018,aia,Anguilla,0,585,-585,AIA
2018,atg,Antigua y Barbuda,8136,4125,4011,ATG
2018,bes,Bonaire,0,3801,-3801,BES
2018,blz,Belice,3044681,2516,3042165,BLZ
2018,brb,Barbados,1342693,51,1342642,BRB
2018,can,Canadá,6120267125,1621125393,4499141732,CAN
2018,cri,Costa Rica,99629022,2055922,97573100,CRI
2018,cub,Cuba,1620247,4,1620243,CUB
2018,cuw,Curaçao,8437291,67422,8369869,CUW
2018,cym,Islas Caimán,706974,14,706960,CYM
2018,dma,Dominica,27650681,53495,27597186,DMA
2018,dom,República Dominicana,19359930,226140,19133790,DOM
2018,grl,Groenlandia,0,1032,-1032,GRL
2018,gtm,Guatemala,71682298,1130307,70551991,GTM
2018,hnd,Honduras,47339436,16922771,30416665,HND
2018,jam,Jamaica,6983554,1202,6982352,JAM
2018,kna,Saint Kitts y Nevis,285908,206,285702,KNA
2018,nic,Nicaragua,16393597,58,16393539,NIC
2018,pan,Panamá,133830482,26262,133804220,PAN
2018,pri,Puerto Rico,273720039,1086687,272633352,PRI
2018,slv,El Salvador,33092383,5381,33087002,SLV
2018,tca,Turcas y Caicos,356250,698,355552,TCA
2018,usa,Estados Unidos,92637607813,20451271334,72186336479,USA
2018,vgb,Islas Vírgenes Británicas,13584110,19411285,-5827175,VGB
2018,vir,Islas Vírgenes,0,308,-308,VIR
2018,sxm,San Martín,2448942,171,2448771,SXM
2018,asm,Samoa Americana,0,257,-257,ASM
2018,aus,Australia,406790056,4585505,402204551,AUS
2018,cok,Islas Cook,0,688,-688,COK
2018,fsm,Micronesia,1850495,76,1850419,FSM
2018,mhl,Islas Marshall,0,389,-389,MHL
2018,ncl,Nueva Caledonia,287421,18,287403,NCL
2018,nzl,Nueva Zelandia,96302328,187811,96114517,NZL
2018,pcn,Islas Pitcairn,0,137,-137,PCN
2018,plw,Palau,0,68,-68,PLW
2018,slb,Islas Salomón,0,143,-143,SLB
2018,tkl,Tokelau,0,3550,-3550,TKL
2018,wsm,Samoa,0,49266,-49266,WSM
2018,arg,Argentina,575663855,154110305,421553550,ARG
2018,bol,Bolivia,32688558,1448,32687110,BOL
2018,bra,Brasil,1869456485,693882459,1175574026,BRA
2018,chl,Chile,697495060,7200730,690294330,CHL
2018,col,Colombia,865898003,120598090,745299913,COL
2018,ecu,Ecuador,203796191,9946,203786245,ECU
2018,per,Perú,359610854,41440,359569414,PER
2018,sur,Suriname,123554,524,123030,SUR
2018,ury,Uruguay,71244298,160299,71083999,URY
2018,ven,Venezuela,6052276,99942,5952334,VEN
2018,ago,Angola,1234062,0,1234062,AGO
2018,ben,Benin,21774,0,21774,BEN
2018,bwa,Botswana,112593,0,112593,BWA
2018,cog,"Congo, República del",40752,0,40752,COG
2018,cpv,Cabo Verde,180063,0,180063,CPV
2018,dji,Djibouti,78328,0,78328,DJI
2018,dza,Argelia,36345301,0,36345301,DZA
2018,eth,Etiopía,377569,0,377569,ETH
2018,gnq,Guinea Ecuatorial,50173,0,50173,GNQ
2018,lbr,Liberia,307411,0,307411,LBR
2018,mus,Mauricio,1236369,0,1236369,MUS
2018,nam,Namibia,487071,0,487071,NAM
2018,nga,Nigeria,3514037,0,3514037,NGA
2018,sdn,Sudán,925064,0,925064,SDN
2018,aze,Azerbaiyán,1264594,0,1264594,AZE
2018,bhr,Bahrein,6004204,0,6004204,BHR
2018,kaz,Kazajstán,1785026,0,1785026,KAZ
2018,kwt,Kuwait,21290567,0,21290567,KWT
2018,lao,Laos,7726186,0,7726186,LAO
2018,pse,Palestina,1242188,0,1242188,PSE
2018,gib,Gibraltar,181965,0,181965,GIB
2018,bhs,Las Bahamas,4876156,0,4876156,BHS
2018,bmu,Bermuda,168,0,168,BMU
2018,grd,Granada,616,0,616,GRD
2018,hti,Haití,15358531,0,15358531,HTI
2018,lca,Santa Lucía,89905,0,89905,LCA
2018,maf,San Martín,6498036,0,6498036,MAF
2018,tto,Trinidad y Tobago,3164237,0,3164237,TTO
2018,glp,Guadalupe,736108,0,736108,GLP
2018,mtq,Martinica,735606,0,735606,MTQ
2018,fji,Fiji,77000,0,77000,FJI
2018,gum,Guam,182319,0,182319,GUM
2018,mnp,Islas Marianas del Norte,38222,0,38222,MNP
2018,pyf,Polinesia francés,326023,0,326023,PYF
2018,guy,Guayana,761062,0,761062,GUY
2018,pry,Paraguay,61294273,0,61294273,PRY
2018,guf,Guayana Francesa,377669,0,377669,GUF
2017,bfa,Burkina Faso,47844,272,47572,BFA
2017,caf,República Centroafricana,0,3027,-3027,CAF
2017,cmr,Camerún,0,272,-272,CMR
2017,dji,Djibouti,0,20,-20,DJI
2017,egy,Egipto,3231470,18582,3212888,EGY
2017,eri,Eritrea,0,30,-30,ERI
2017,esh,Sahara Occidental,0,832,-832,ESH
2017,eth,Etiopía,235100,955,234145,ETH
2017,gab,Gabón,0,3612,-3612,GAB
2017,gha,Ghana,898874,3551,895323,GHA
2017,gin,Guinea,29017,354,28663,GIN
2017,gmb,Gambia,0,327,-327,GMB
2017,ken,Kenia,709875,222380,487495,KEN
2017,lby,Libia,1852,3,1849,LBY
2017,mar,Marruecos,7913656,18273,7895383,MAR
2017,mus,Mauricio,431838,7179,424659,MUS
2017,mwi,Malawi,0,493,-493,MWI
2017,nam,Namibia,197971,849,197122,NAM
2017,ner,Níger,0,1412,-1412,NER
2017,reu,Réunion,191514,173462,18052,REU
2017,sen,Senegal,548446,4278,544168,SEN
2017,sle,Sierra Leona,0,360436,-360436,SLE
2017,som,Somalia,0,309,-309,SOM
2017,swz,Esuatini,330568,38077,292491,SWZ
2017,syc,Seychelles,0,7833,-7833,SYC
2017,tcd,Chad,0,258,-258,TCD
2017,tgo,Togo,0,113,-113,TGO
2017,tun,Túnez,1294380,112731,1181649,TUN
2017,uga,Uganda,165874,5586,160288,UGA
2017,zaf,Sudáfrica,20387408,10180558,10206850,ZAF
2017,ata,Antártida,0,65,-65,ATA
2017,afg,Afganistán,0,593,-593,AFG
2017,are,Emiratos Árabes Unidos,73163546,2096457,71067089,ARE
2017,arm,Armenia,1426208,980,1425228,ARM
2017,aze,Azerbaiyán,595756,776,594980,AZE
2017,bgd,Bangladesh,0,48724,-48724,BGD
2017,btn,Bhutan,0,33,-33,BTN
2017,chn,China,1239510777,3051130743,-1811619966,CHN
2017,cyp,Chipre,4018691,803,4017888,CYP
2017,geo,Georgia,345691,919,344772,GEO
2017,hkg,Hong Kong,29322037,1708926,27613111,HKG
2017,idn,Indonesia,4193689,150659091,-146465402,IDN
2017,ind,India,60389838,1989368751,-1928978913,IND
2017,isr,Israel,91044869,968079,90076790,ISR
2017,jor,Jordania,6147257,12264,6134993,JOR
2017,jpn,Japón,554935626,3867224289,-3312288663,JPN
2017,kaz,Kazajstán,878882,46,878836,KAZ
2017,khm,Camboya,1183253,938552,244701,KHM
2017,kor,Corea del Sur,207379329,2079129869,-1871750540,KOR
2017,kwt,Kuwait,13157853,225,13157628,KWT
2017,lao,Laos,0,1544,-1544,LAO
2017,lka,Sri Lanka,458736,398920,59816,LKA
2017,mac,Macau,128176,690,127486,MAC
2017,mmr,Birmania,369156,56443,312713,MMR
2017,mys,Malasia,8032756,11405218,-3372462,MYS
2017,npl,Nepal,87273,78,87195,NPL
2017,omn,Omán,11697213,11645729,51484,OMN
2017,pak,Pakistán,603250,166034,437216,PAK
2017,phl,Filipinas,9599237,11817193,-2217956,PHL
2017,prk,Corea del Norte,69275,93961,-24686,PRK
2017,qat,Katar,9073393,9721,9063672,QAT
2017,sau,Arabia Saudita,24543359,105820,24437539,SAU
2017,sgp,Singapur,9392535,12303308,-2910773,SGP
2017,syr,Siria,0,41,-41,SYR
2017,tha,Tailandia,115918686,1114416626,-998497940,THA
2017,tjk,Tayikistán,0,84,-84,TJK
2017,tkm,Turkmenistán,0,33,-33,TKM
2017,tur,Turquía,19542551,149961949,-130419398,TUR
2017,twn,Taiwan,31366112,193411516,-162045404,TWN
2017,uzb,Uzbekistán,373419,4251,369168,UZB
2017,vnm,Vietnam,15288180,57087991,-41799811,VNM
2017,yem,Yemen,0,11554,-11554,YEM
2017,alb,Albania,0,597,-597,ALB
2017,and,Andorra,13208,21558,-8350,AND
2017,aut,Austria,133171633,118614497,14557136,AUT
2017,bel,Bélgica,398554228,37393430,361160798,BEL
2017,bgr,Bulgaria,402156,2542071,-2139915,BGR
2017,bih,Bosnia y Herzegovina,760257,8543476,-7783219,BIH
2017,blr,Bielorrusia,0,129856,-129856,BLR
2017,che,Suiza,66277149,45748191,20528958,CHE
2017,cze,Chequia,20874761,387903233,-367028472,CZE
2017,deu,Alemania,4539038813,2773321255,1765717558,DEU
2017,dnk,Dinamarca,36333000,4343359,31989641,DNK
2017,emu,Comunidad Europea,0,315210,-315210,EMU
2017,esp,España,249330803,515247411,-265916608,ESP
2017,est,Estonia,5591578,11008917,-5417339,EST
2017,fin,Finlandia,82337008,21888653,60448355,FIN
2017,fra,Francia,204352369,296101410,-91749041,FRA
2017,gbr,Reino Unido,369972136,247798125,122174011,GBR
2017,gib,Gibraltar,214541,3062,211479,GIB
2017,grc,Grecia,8694885,122155,8572730,GRC
2017,hrv,Croacia,13968156,577762,13390394,HRV
2017,hun,Hungría,28353323,283205442,-254852119,HUN
2017,irl,Irlanda,3653330,349639,3303691,IRL
2017,isl,Islandia,2250833,72034,2178799,ISL
2017,ita,Italia,417962249,495995941,-78033692,ITA
2017,lie,Liechtenstein,2428952,54779,2374173,LIE
2017,ltu,Lituania,39523,39781,-258,LTU
2017,lux,Luxemburgo,2543159,998123,1545036,LUX
2017,lva,Letonia,0,40898,-40898,LVA
2017,mco,Mónaco,0,24618,-24618,MCO
2017,mkd,Macedonia del Norte,73285,2789079,-2715794,MKD
2017,mlt,Malta,277925,271,277654,MLT
2017,mne,Montenegro,0,5,-5,MNE
2017,nld,Países Bajos,76253260,84270693,-8017433,NLD
2017,nor,Noruega,8524502,6092889,2431613,NOR
2017,pol,Polonia,81874189,131869907,-49995718,POL
2017,prt,Portugal,20023641,34929634,-14905993,PRT
2017,rke,Islas del Canal (Islas Normandas),0,67,-67,RKE
2017,rou,Rumania,20408010,41042532,-20634522,ROU
2017,rus,Rusia,77669162,7681280,69987882,RUS
2017,smr,San Marino,0,1922,-1922,SMR
2017,srb,Serbia,645796,644700,1096,SRB
2017,svk,Eslovaquia,12175427,77882514,-65707087,SVK
2017,svn,Eslovenia,9859096,5811558,4047538,SVN
2017,swe,Suecia,18665431,90941625,-72276194,SWE
2017,ukr,Ucrania,4964951,24400,4940551,UKR
2017,yug,Yugoslavia,0,19791,-19791,YUG
2017,abw,Aruba,7537617,291230,7246387,ABW
2017,atg,Antigua y Barbuda,100932,556,100376,ATG
2017,bhs,Las Bahamas,2553726,452,2553274,BHS
2017,blz,Belice,2993057,45,2993012,BLZ
2017,brb,Barbados,552675,4707,547968,BRB
2017,can,Canadá,4813460482,1447831079,3365629403,CAN
2017,cri,Costa Rica,106672631,1978920,104693711,CRI
2017,cub,Cuba,392009,1590,390419,CUB
2017,cuw,Curaçao,9023407,17,9023390,CUW
2017,dma,Dominica,28832721,373429,28459292,DMA
2017,dom,República Dominicana,18831398,596870,18234528,DOM
2017,grd,Granada,0,121,-121,GRD
2017,grl,Groenlandia,0,20749,-20749,GRL
2017,gtm,Guatemala,63581606,1976289,61605317,GTM
2017,hnd,Honduras,50388092,7934574,42453518,HND
2017,nic,Nicaragua,31722466,3181,31719285,NIC
2017,pan,Panamá,123253497,26734,123226763,PAN
2017,pri,Puerto Rico,144511535,1089110,143422425,PRI
2017,slv,El Salvador,42911577,15196,42896381,SLV
2017,tca,Turcas y Caicos,194232,213,194019,TCA
2017,usa,Estados Unidos,82435045386,19694459650,62740585736,USA
2017,vgb,Islas Vírgenes Británicas,129422,19978470,-19849048,VGB
2017,vir,Islas Vírgenes,0,402,-402,VIR
2017,pcz,Zona del Canal de Panamá,0,6,-6,PCZ
2017,aus,Australia,314030933,7221322,306809611,AUS
2017,cok,Islas Cook,0,32,-32,COK
2017,fsm,Micronesia,15625,13984,1641,FSM
2017,mhl,Islas Marshall,0,830,-830,MHL
2017,ncl,Nueva Caledonia,89836,63,89773,NCL
2017,nzl,Nueva Zelandia,53530716,72978,53457738,NZL
2017,plw,Palau,0,4280,-4280,PLW
2017,slb,Islas Salomón,0,7650,-7650,SLB
2017,tkl,Tokelau,0,4258,-4258,TKL
2017,ton,Tonga,0,14,-14,TON
2017,wsm,Samoa,0,28296,-28296,WSM
2017,arg,Argentina,744532658,237329231,507203427,ARG
2017,bol,Bolivia,49637380,11,49637369,BOL
2017,bra,Brasil,1293845804,998277117,295568687,BRA
2017,chl,Chile,504211652,13400267,490811385,CHL
2017,col,Colombia,745747353,177941739,567805614,COL
2017,ecu,Ecuador,132970012,26143,132943869,ECU
2017,per,Perú,284580120,170213,284409907,PER
2017,sur,Suriname,311521,825,310696,SUR
2017,ury,Uruguay,63414539,26411,63388128,URY
2017,ven,Venezuela,12117395,69405,12047990,VEN
2017,ago,Angola,844048,0,844048,AGO
2017,ben,Benin,71314,0,71314,BEN
2017,civ,Côte d'Ivoire,1403741,0,1403741,CIV
2017,cog,"Congo, República del",89535,0,89535,COG
2017,cpv,Cabo Verde,157806,0,157806,CPV
2017,dza,Argelia,1484230,0,1484230,DZA
2017,lbr,Liberia,115826,0,115826,LBR
2017,mdg,Madagascar,48019,0,48019,MDG
2017,moz,Mozambique,80284,0,80284,MOZ
2017,mrt,Mauritania,871284,0,871284,MRT
2017,nga,Nigeria,7173681,0,7173681,NGA
2017,rwa,Ruanda,134680,0,134680,RWA
2017,tza,Tanzania,351285,0,351285,TZA
2017,zmb,Zambia,528765,0,528765,ZMB
2017,zwe,Zimbabue,486105,0,486105,ZWE
2017,bhr,Bahrein,4758210,0,4758210,BHR
2017,brn,Brunéi,3521434,0,3521434,BRN
2017,irn,Irán,516708,0,516708,IRN
2017,irq,Irak,1173608,0,1173608,IRQ
2017,lbn,Líbano,21175973,0,21175973,LBN
2017,mng,Mongolia,173894,0,173894,MNG
2017,pse,Palestina,716660,0,716660,PSE
2017,ant,Antillas Holandesas,1679773,0,1679773,ANT
2017,bes,Bonaire,312000,0,312000,BES
2017,cym,Islas Caimán,296898,0,296898,CYM
2017,hti,Haití,11096326,0,11096326,HTI
2017,jam,Jamaica,6086240,0,6086240,JAM
2017,lca,Santa Lucía,184905,0,184905,LCA
2017,maf,San Martín,4975646,0,4975646,MAF
2017,tto,Trinidad y Tobago,4463367,0,4463367,TTO
2017,glp,Guadalupe,703923,0,703923,GLP
2017,mtq,Martinica,500448,0,500448,MTQ
2017,sxm,San Martín,1439694,0,1439694,SXM
2017,gum,Guam,589588,0,589588,GUM
2017,pyf,Polinesia francés,74291,0,74291,PYF
2017,guy,Guayana,174114,0,174114,GUY
2017,pry,Paraguay,34381135,0,34381135,PRY
2017,guf,Guayana Francesa,437076,0,437076,GUF
2016,ago,Angola,708050,337,707713,AGO
2016,bfa,Burkina Faso,0,415,-415,BFA
2016,bwa,Botswana,0,167,-167,BWA
2016,caf,República Centroafricana,0,63284,-63284,CAF
2016,civ,Côte d'Ivoire,357203,47,357156,CIV
2016,cmr,Camerún,0,1813,-1813,CMR
2016,cod,"Congo, República Democrática del",0,74,-74,COD
2016,egy,Egipto,738124,39637,698487,EGY
2016,eth,Etiopía,337630,751,336879,ETH
2016,gab,Gabón,108974,49567,59407,GAB
2016,gha,Ghana,0,92,-92,GHA
2016,gin,Guinea,0,92,-92,GIN
2016,gmb,Gambia,0,261,-261,GMB
2016,gnb,Guinea-Bissau,0,143,-143,GNB
2016,ken,Kenia,4093530,363556,3729974,KEN
2016,mar,Marruecos,1962899,2286,1960613,MAR
2016,mwi,Malawi,0,518,-518,MWI
2016,nam,Namibia,252421,132864,119557,NAM
2016,reu,Réunion,0,258,-258,REU
2016,sdn,Sudán,0,398,-398,SDN
2016,sen,Senegal,0,18660,-18660,SEN
2016,shn,Santa Elena,0,17777,-17777,SHN
2016,sle,Sierra Leona,0,8692,-8692,SLE
2016,swz,Esuatini,65039,16764,48275,SWZ
2016,syc,Seychelles,0,741,-741,SYC
2016,tun,Túnez,398901,107014,291887,TUN
2016,tza,Tanzania,575380,1236,574144,TZA
2016,uga,Uganda,145922,66617,79305,UGA
2016,zaf,Sudáfrica,15822284,27675290,-11853006,ZAF
2016,zmb,Zambia,269639,412,269227,ZMB
2016,atf,Francés Territorio Sur de la Antártida,0,163,-163,ATF
2016,afg,Afganistán,1199,14117,-12918,AFG
2016,are,Emiratos Árabes Unidos,90749021,239905,90509116,ARE
2016,bgd,Bangladesh,0,125765,-125765,BGD
2016,brn,Brunéi,815755,588,815167,BRN
2016,chn,China,1173424528,2188304089,-1014879561,CHN
2016,cyp,Chipre,1066631,5890,1060741,CYP
2016,geo,Georgia,29578,76158,-46580,GEO
2016,hkg,Hong Kong,2745359,2690033,55326,HKG
2016,idn,Indonesia,3000049,104761290,-101761241,IDN
2016,ind,India,52648749,1597711760,-1545063011,IND
2016,irn,Irán,0,4032,-4032,IRN
2016,isr,Israel,56059419,2095244,53964175,ISR
2016,jor,Jordania,799380,225406,573974,JOR
2016,jpn,Japón,420469017,4162355168,-3741886151,JPN
2016,kaz,Kazajstán,975,699,276,KAZ
2016,khm,Camboya,661553,881862,-220309,KHM
2016,kor,Corea del Sur,189739960,1802751759,-1613011799,KOR
2016,lao,Laos,0,7,-7,LAO
2016,lka,Sri Lanka,0,162055,-162055,LKA
2016,mac,Macau,0,10113,-10113,MAC
2016,mys,Malasia,3321932,11052319,-7730387,MYS
2016,omn,Omán,11496708,13576716,-2080008,OMN
2016,pak,Pakistán,3957,179210,-175253,PAK
2016,phl,Filipinas,2867706,10490713,-7623007,PHL
2016,prk,Corea del Norte,0,868779,-868779,PRK
2016,qat,Katar,3306044,215725,3090319,QAT
2016,sau,Arabia Saudita,6630939,1567,6629372,SAU
2016,sgp,Singapur,8547878,9493813,-945935,SGP
2016,syr,Siria,0,1286,-1286,SYR
2016,tha,Tailandia,99286883,878988041,-779701158,THA
2016,tjk,Tayikistán,0,10,-10,TJK
2016,tkm,Turkmenistán,0,725,-725,TKM
2016,tur,Turquía,7165001,152759941,-145594940,TUR
2016,twn,Taiwan,9926560,192522044,-182595484,TWN
2016,uzb,Uzbekistán,320534,3280,317254,UZB
2016,vnm,Vietnam,8377026,54498635,-46121609,VNM
2016,yem,Yemen,0,23189,-23189,YEM
2016,alb,Albania,15288,3346,11942,ALB
2016,and,Andorra,0,6,-6,AND
2016,ant,Antillas Holandesas,1075353,835,1074518,ANT
2016,aut,Austria,86105481,56235153,29870328,AUT
2016,bel,Bélgica,136582539,38057439,98525100,BEL
2016,bgr,Bulgaria,0,2187508,-2187508,BGR
2016,bih,Bosnia y Herzegovina,0,5975525,-5975525,BIH
2016,blr,Bielorrusia,0,93,-93,BLR
2016,che,Suiza,65382580,38137704,27244876,CHE
2016,cze,Chequia,19362677,300887925,-281525248,CZE
2016,deu,Alemania,1966371092,1945485215,20885877,DEU
2016,dnk,Dinamarca,42000217,1897776,40102441,DNK
2016,emu,Comunidad Europea,0,176972,-176972,EMU
2016,esp,España,165399804,547706520,-382306716,ESP
2016,est,Estonia,374329,8861012,-8486683,EST
2016,fin,Finlandia,84488150,10934589,73553561,FIN
2016,fra,Francia,78404437,211138903,-132734466,FRA
2016,gbr,Reino Unido,873376909,155972548,717404361,GBR
2016,grc,Grecia,6800,151770,-144970,GRC
2016,hrv,Croacia,7707193,87462,7619731,HRV
2016,hun,Hungría,13066714,221824165,-208757451,HUN
2016,irl,Irlanda,54881,157006,-102125,IRL
2016,isl,Islandia,5140,2375,2765,ISL
2016,ita,Italia,76457541,396420651,-319963110,ITA
2016,lie,Liechtenstein,2676300,20027,2656273,LIE
2016,ltu,Lituania,34622,36356,-1734,LTU
2016,lux,Luxemburgo,137791,1082150,-944359,LUX
2016,lva,Letonia,0,136218,-136218,LVA
2016,mco,Mónaco,0,12679,-12679,MCO
2016,mkd,Macedonia del Norte,357623,41293,316330,MKD
2016,mlt,Malta,10001,47846,-37845,MLT
2016,mne,Montenegro,0,42,-42,MNE
2016,nld,Países Bajos,51498625,72489741,-20991116,NLD
2016,nor,Noruega,9811516,1048020,8763496,NOR
2016,pol,Polonia,67243114,88879494,-21636380,POL
2016,prt,Portugal,16495697,16452470,43227,PRT
2016,rke,Islas del Canal (Islas Normandas),0,728,-728,RKE
2016,rou,Rumania,6803840,27894095,-21090255,ROU
2016,rus,Rusia,61710832,17086592,44624240,RUS
2016,sjm,Svalbard y Jan Mayen,0,11920,-11920,SJM
2016,smr,San Marino,0,2775,-2775,SMR
2016,srb,Serbia,1583,5965885,-5964302,SRB
2016,svk,Eslovaquia,11119839,113815672,-102695833,SVK
2016,svn,Eslovenia,6545939,2160691,4385248,SVN
2016,swe,Suecia,26939931,81939101,-54999170,SWE
2016,ukr,Ucrania,4228728,228634,4000094,UKR
2016,abw,Aruba,3932281,155808,3776473,ABW
2016,atg,Antigua y Barbuda,12009,1245,10764,ATG
2016,blz,Belice,4157558,1405,4156153,BLZ
2016,bmu,Bermuda,27,2091,-2064,BMU
2016,brb,Barbados,590323,1886,588437,BRB
2016,can,Canadá,4560881705,1575458070,2985423635,CAN
2016,cri,Costa Rica,118000584,1609300,116391284,CRI
2016,cub,Cuba,2005020,4173,2000847,CUB
2016,dom,República Dominicana,48388297,547036,47841261,DOM
2016,gtm,Guatemala,62684449,1103934,61580515,GTM
2016,hnd,Honduras,40042822,8866126,31176696,HND
2016,nic,Nicaragua,28755036,7181,28747855,NIC
2016,pan,Panamá,109512779,102595,109410184,PAN
2016,pri,Puerto Rico,77781624,1306939,76474685,PRI
2016,slv,El Salvador,30635423,1687,30633736,SLV
2016,tca,Turcas y Caicos,270072,851,269221,TCA
2016,tto,Trinidad y Tobago,1175985,13287,1162698,TTO
2016,usa,Estados Unidos,73576231384,18201088421,55375142963,USA
2016,vgb,Islas Vírgenes Británicas,4005,11758011,-11754006,VGB
2016,pcz,Zona del Canal de Panamá,0,80,-80,PCZ
2016,aus,Australia,86453948,2776038,83677910,AUS
2016,cok,Islas Cook,0,422,-422,COK
2016,mhl,Islas Marshall,0,936,-936,MHL
2016,nru,Nauru,0,2390,-2390,NRU
2016,nzl,Nueva Zelandia,30731741,91007,30640734,NZL
2016,plw,Palau,0,46705,-46705,PLW
2016,pyf,Polinesia francés,45458,17193,28265,PYF
2016,slb,Islas Salomón,0,8,-8,SLB
2016,tkl,Tokelau,0,3305,-3305,TKL
2016,wsm,Samoa,0,14,-14,WSM
2016,arg,Argentina,637543604,284414557,353129047,ARG
2016,bra,Brasil,1080307660,811984123,268323537,BRA
2016,chl,Chile,364067645,7463167,356604478,CHL
2016,col,Colombia,716797697,191694361,525103336,COL
2016,ecu,Ecuador,36282968,22789,36260179,ECU
2016,guy,Guayana,67925,613,67312,GUY
2016,per,Perú,246432402,478672,245953730,PER
2016,pry,Paraguay,15851475,5,15851470,PRY
2016,sur,Suriname,49556,909,48647,SUR
2016,ury,Uruguay,29791346,7219,29784127,URY
2016,ven,Venezuela,23264181,161006,23103175,VEN
2016,dza,Argelia,116628,0,116628,DZA
2016,moz,Mozambique,408327,0,408327,MOZ
2016,nga,Nigeria,1180,0,1180,NGA
2016,rwa,Ruanda,67340,0,67340,RWA
2016,zwe,Zimbabue,467220,0,467220,ZWE
2016,arm,Armenia,119647,0,119647,ARM
2016,aze,Azerbaiyán,103132,0,103132,AZE
2016,bhr,Bahrein,477680,0,477680,BHR
2016,irq,Irak,182760,0,182760,IRQ
2016,kwt,Kuwait,5545069,0,5545069,KWT
2016,lbn,Líbano,1167329,0,1167329,LBN
2016,mmr,Birmania,994905,0,994905,MMR
2016,mng,Mongolia,222245,0,222245,MNG
2016,pse,Palestina,170043,0,170043,PSE
2016,aia,Anguilla,30955,0,30955,AIA
2016,bhs,Las Bahamas,1543820,0,1543820,BHS
2016,cuw,Curaçao,2335898,0,2335898,CUW
2016,cym,Islas Caimán,20418,0,20418,CYM
2016,dma,Dominica,3874680,0,3874680,DMA
2016,hti,Haití,1879301,0,1879301,HTI
2016,jam,Jamaica,1477420,0,1477420,JAM
2016,lca,Santa Lucía,31285,0,31285,LCA
2016,maf,San Martín,976498,0,976498,MAF
2016,glp,Guadalupe,279950,0,279950,GLP
2016,mtq,Martinica,1101125,0,1101125,MTQ
2016,fsm,Micronesia,157094,0,157094,FSM
2016,bol,Bolivia,24998401,0,24998401,BOL
2016,guf,Guayana Francesa,714085,0,714085,GUF
2015,ago,Angola,540300,0,540300,AGO
2015,ben,Benin,64434,0,64434,BEN
2015,civ,Côte d'Ivoire,262469,0,262469,CIV
2015,cog,"Congo, República del",133454,0,133454,COG
2015,egy,Egipto,2836768,0,2836768,EGY
2015,eri,Eritrea,76717,0,76717,ERI
2015,gha,Ghana,357209,0,357209,GHA
2015,ken,Kenia,1953799,0,1953799,KEN
2015,lbr,Liberia,119760,0,119760,LBR
2015,lby,Libia,1342,0,1342,LBY
2015,mar,Marruecos,4241454,0,4241454,MAR
2015,moz,Mozambique,413302,0,413302,MOZ
2015,mus,Mauricio,190714,0,190714,MUS
2015,nam,Namibia,154413,0,154413,NAM
2015,nga,Nigeria,1620993,0,1620993,NGA
2015,sen,Senegal,37038,0,37038,SEN
2015,tun,Túnez,1766,0,1766,TUN
2015,tza,Tanzania,135693,0,135693,TZA
2015,uga,Uganda,64650,0,64650,UGA
2015,zaf,Sudáfrica,42448801,0,42448801,ZAF
2015,zwe,Zimbabue,163963,0,163963,ZWE
2015,afg,Afganistán,12042,0,12042,AFG
2015,are,Emiratos Árabes Unidos,112297244,0,112297244,ARE
2015,arm,Armenia,75415,0,75415,ARM
2015,aze,Azerbaiyán,460000,0,460000,AZE
2015,bhr,Bahrein,4911714,0,4911714,BHR
2015,brn,Brunéi,935337,0,935337,BRN
2015,chn,China,1431788054,0,1431788054,CHN
2015,cyp,Chipre,1490343,0,1490343,CYP
2015,hkg,Hong Kong,2607207,0,2607207,HKG
2015,idn,Indonesia,11702606,0,11702606,IDN
2015,ind,India,74459251,0,74459251,IND
2015,irq,Irak,6104539,0,6104539,IRQ
2015,isr,Israel,36942984,0,36942984,ISR
2015,jor,Jordania,108128,0,108128,JOR
2015,jpn,Japón,232920554,0,232920554,JPN
2015,kaz,Kazajstán,10302,0,10302,KAZ
2015,khm,Camboya,447156,0,447156,KHM
2015,kor,Corea del Sur,151371277,0,151371277,KOR
2015,kwt,Kuwait,59491626,0,59491626,KWT
2015,lao,Laos,16,0,16,LAO
2015,lbn,Líbano,477281,0,477281,LBN
2015,lka,Sri Lanka,75143,0,75143,LKA
2015,mmr,Birmania,384001,0,384001,MMR
2015,mng,Mongolia,317714,0,317714,MNG
2015,mys,Malasia,2987962,0,2987962,MYS
2015,omn,Omán,22702656,0,22702656,OMN
2015,pak,Pakistán,16393,0,16393,PAK
2015,phl,Filipinas,2624937,0,2624937,PHL
2015,pse,Palestina,245341,0,245341,PSE
2015,qat,Katar,26220457,0,26220457,QAT
2015,sau,Arabia Saudita,258499679,0,258499679,SAU
2015,sgp,Singapur,21503145,0,21503145,SGP
2015,tha,Tailandia,102300326,0,102300326,THA
2015,tur,Turquía,11960835,0,11960835,TUR
2015,twn,Taiwan,11735436,0,11735436,TWN
2015,uzb,Uzbekistán,821172,0,821172,UZB
2015,vnm,Vietnam,5736834,0,5736834,VNM
2015,yem,Yemen,83670,0,83670,YEM
2015,ant,Antillas Holandesas,2129300,0,2129300,ANT
2015,aut,Austria,93612630,0,93612630,AUT
2015,bel,Bélgica,134509947,0,134509947,BEL
2015,bgr,Bulgaria,4341815,0,4341815,BGR
2015,che,Suiza,95529656,0,95529656,CHE
2015,cze,Chequia,24006993,0,24006993,CZE
2015,deu,Alemania,1739308502,0,1739308502,DEU
2015,dnk,Dinamarca,44484306,0,44484306,DNK
2015,emu,Comunidad Europea,563295,0,563295,EMU
2015,esp,España,126626851,0,126626851,ESP
2015,est,Estonia,168980,0,168980,EST
2015,fin,Finlandia,67719811,0,67719811,FIN
2015,fra,Francia,83173597,0,83173597,FRA
2015,gbr,Reino Unido,450443618,0,450443618,GBR
2015,grc,Grecia,24785,0,24785,GRC
2015,hrv,Croacia,10085753,0,10085753,HRV
2015,hun,Hungría,26868435,0,26868435,HUN
2015,irl,Irlanda,2053,0,2053,IRL
2015,isl,Islandia,1991,0,1991,ISL
2015,ita,Italia,172961513,0,172961513,ITA
2015,lie,Liechtenstein,2086243,0,2086243,LIE
2015,ltu,Lituania,1384935,0,1384935,LTU
2015,lux,Luxemburgo,36075,0,36075,LUX
2015,mkd,Macedonia del Norte,544149,0,544149,MKD
2015,mlt,Malta,107648,0,107648,MLT
2015,nld,Países Bajos,53890116,0,53890116,NLD
2015,nor,Noruega,17035205,0,17035205,NOR
2015,pol,Polonia,87887460,0,87887460,POL
2015,prt,Portugal,17434455,0,17434455,PRT
2015,rou,Rumania,43689756,0,43689756,ROU
2015,rus,Rusia,99826824,0,99826824,RUS
2015,srb,Serbia,24624,0,24624,SRB
2015,svk,Eslovaquia,13874889,0,13874889,SVK
2015,svn,Eslovenia,6677026,0,6677026,SVN
2015,swe,Suecia,71645124,0,71645124,SWE
2015,ukr,Ucrania,2506111,0,2506111,UKR
2015,abw,Aruba,3434011,0,3434011,ABW
2015,aia,Anguilla,62,0,62,AIA
2015,atg,Antigua y Barbuda,10150,0,10150,ATG
2015,bhs,Las Bahamas,2489219,0,2489219,BHS
2015,blz,Belice,2244584,0,2244584,BLZ
2015,bmu,Bermuda,449,0,449,BMU
2015,brb,Barbados,687755,0,687755,BRB
2015,can,Canadá,4459991718,0,4459991718,CAN
2015,cri,Costa Rica,85251864,0,85251864,CRI
2015,cub,Cuba,1205456,0,1205456,CUB
2015,cuw,Curaçao,4295316,0,4295316,CUW
2015,cym,Islas Caimán,156405,0,156405,CYM
2015,dom,República Dominicana,38939341,0,38939341,DOM
2015,gtm,Guatemala,61317691,0,61317691,GTM
2015,hnd,Honduras,34367140,0,34367140,HND
2015,hti,Haití,1547800,0,1547800,HTI
2015,jam,Jamaica,2597547,0,2597547,JAM
2015,lca,Santa Lucía,64694,0,64694,LCA
2015,nic,Nicaragua,27576660,0,27576660,NIC
2015,pan,Panamá,100451765,0,100451765,PAN
2015,pri,Puerto Rico,63658253,0,63658253,PRI
2015,slv,El Salvador,29982105,0,29982105,SLV
2015,tca,Turcas y Caicos,317355,0,317355,TCA
2015,tto,Trinidad y Tobago,2190605,0,2190605,TTO
2015,usa,Estados Unidos,75543264216,0,75543264216,USA
2015,vgb,Islas Vírgenes Británicas,13978,0,13978,VGB
2015,glp,Guadalupe,884413,0,884413,GLP
2015,mtq,Martinica,508113,0,508113,MTQ
2015,pcz,Zona del Canal de Panamá,6877,0,6877,PCZ
2015,aus,Australia,163637225,0,163637225,AUS
2015,fji,Fiji,8151,0,8151,FJI
2015,fsm,Micronesia,9452,0,9452,FSM
2015,kir,Kiribati,58357,0,58357,KIR
2015,nzl,Nueva Zelandia,29612623,0,29612623,NZL
2015,pyf,Polinesia francés,54772,0,54772,PYF
2015,arg,Argentina,585444881,0,585444881,ARG
2015,bol,Bolivia,27863492,0,27863492,BOL
2015,bra,Brasil,1311825550,0,1311825550,BRA
2015,chl,Chile,365682873,0,365682873,CHL
2015,col,Colombia,770959693,0,770959693,COL
2015,ecu,Ecuador,50263738,0,50263738,ECU
2015,guy,Guayana,214097,0,214097,GUY
2015,per,Perú,272129411,0,272129411,PER
2015,pry,Paraguay,20403747,0,20403747,PRY
2015,sur,Suriname,142245,0,142245,SUR
2015,ury,Uruguay,67253516,0,67253516,URY
2015,ven,Venezuela,47871707,0,47871707,VEN
2015,guf,Guayana Francesa,1994794,0,1994794,GUF
2014,bfa,Burkina Faso,0,73,-73,BFA
2014,caf,República Centroafricana,6835,170889,-164054,CAF
2014,civ,Côte d'Ivoire,1931,237,1694,CIV
2014,cmr,Camerún,0,2771,-2771,CMR
2014,cog,"Congo, República del",0,223,-223,COG
2014,egy,Egipto,1828026,61039,1766987,EGY
2014,eri,Eritrea,0,557,-557,ERI
2014,gha,Ghana,56693,670,56023,GHA
2014,ken,Kenia,1911016,612686,1298330,KEN
2014,lby,Libia,0,412,-412,LBY
2014,mar,Marruecos,1869404,78356,1791048,MAR
2014,mrt,Mauritania,0,2089,-2089,MRT
2014,mwi,Malawi,0,648,-648,MWI
2014,nam,Namibia,0,15,-15,NAM
2014,nga,Nigeria,1513935,60,1513875,NGA
2014,sdn,Sudán,135565,561,135004,SDN
2014,sen,Senegal,0,13475,-13475,SEN
2014,sle,Sierra Leona,0,1495,-1495,SLE
2014,swz,Esuatini,0,9862,-9862,SWZ
2014,tcd,Chad,0,148,-148,TCD
2014,tun,Túnez,89843,145762,-55919,TUN
2014,tza,Tanzania,0,15742,-15742,TZA
2014,uga,Uganda,142261,3926,138335,UGA
2014,zaf,Sudáfrica,46510006,28571657,17938349,ZAF
2014,zmb,Zambia,443806,537,443269,ZMB
2014,zwe,Zimbabue,280371,262,280109,ZWE
2014,afg,Afganistán,1348,20707,-19359,AFG
2014,are,Emiratos Árabes Unidos,107137545,840317,106297228,ARE
2014,bgd,Bangladesh,0,2455,-2455,BGD
2014,chn,China,2184761246,2001695000,183066246,CHN
2014,cyp,Chipre,1976817,7185,1969632,CYP
2014,geo,Georgia,0,238,-238,GEO
2014,hkg,Hong Kong,7308988,2414955,4894033,HKG
2014,idn,Indonesia,8294363,178528929,-170234566,IDN
2014,ind,India,37324713,970730436,-933405723,IND
2014,irn,Irán,12018,2405,9613,IRN
2014,isr,Israel,17661157,5373130,12288027,ISR
2014,jor,Jordania,2547945,779,2547166,JOR
2014,jpn,Japón,262318386,3452351100,-3190032714,JPN
2014,khm,Camboya,4900,1044013,-1039113,KHM
2014,kor,Corea del Sur,202179293,1174702845,-972523552,KOR
2014,lbn,Líbano,312922,258,312664,LBN
2014,lka,Sri Lanka,20845,157205,-136360,LKA
2014,mac,Macau,0,310465,-310465,MAC
2014,mdv,Maldivas,0,153900,-153900,MDV
2014,mys,Malasia,45010565,9533386,35477179,MYS
2014,omn,Omán,15785851,13336401,2449450,OMN
2014,pak,Pakistán,13799,151286,-137487,PAK
2014,phl,Filipinas,4168824,15391192,-11222368,PHL
2014,prk,Corea del Norte,0,547505,-547505,PRK
2014,qat,Katar,20530894,11499,20519395,QAT
2014,sau,Arabia Saudita,349608783,3917,349604866,SAU
2014,sgp,Singapur,26483649,11537889,14945760,SGP
2014,tha,Tailandia,95511675,435598851,-340087176,THA
2014,tjk,Tayikistán,0,3041,-3041,TJK
2014,tur,Turquía,14849493,121838354,-106988861,TUR
2014,twn,Taiwan,12765565,190348993,-177583428,TWN
2014,uzb,Uzbekistán,2770104,1360,2768744,UZB
2014,vnm,Vietnam,528412,48268976,-47740564,VNM
2014,alb,Albania,0,28230,-28230,ALB
2014,ant,Antillas Holandesas,1738020,5675,1732345,ANT
2014,aut,Austria,44630999,79534999,-34904000,AUT
2014,bel,Bélgica,86664128,77231731,9432397,BEL
2014,bgr,Bulgaria,18884103,1758716,17125387,BGR
2014,bih,Bosnia y Herzegovina,57,1613877,-1613820,BIH
2014,blr,Bielorrusia,0,150120,-150120,BLR
2014,che,Suiza,27401926,32486410,-5084484,CHE
2014,cze,Chequia,8284169,197619630,-189335461,CZE
2014,deu,Alemania,1734107149,2312328040,-578220891,DEU
2014,dnk,Dinamarca,5176945,3496875,1680070,DNK
2014,emu,Comunidad Europea,3098791,229452,2869339,EMU
2014,esp,España,65848765,505245023,-439396258,ESP
2014,est,Estonia,293218,10890433,-10597215,EST
2014,fin,Finlandia,52040956,4812255,47228701,FIN
2014,fra,Francia,46315415,216252699,-169937284,FRA
2014,gbr,Reino Unido,154516617,251769658,-97253041,GBR
2014,gib,Gibraltar,0,843,-843,GIB
2014,grc,Grecia,27247,516881,-489634,GRC
2014,hrv,Croacia,2152779,159071,1993708,HRV
2014,hun,Hungría,18538074,202471326,-183933252,HUN
2014,irl,Irlanda,12351,987572,-975221,IRL
2014,isl,Islandia,0,253,-253,ISL
2014,ita,Italia,211400069,334071833,-122671764,ITA
2014,lie,Liechtenstein,1614670,4494103,-2879433,LIE
2014,ltu,Lituania,2637864,168486,2469378,LTU
2014,lux,Luxemburgo,4148,88001,-83853,LUX
2014,lva,Letonia,48668,53476,-4808,LVA
2014,mco,Mónaco,0,22080,-22080,MCO
2014,mlt,Malta,3113,627,2486,MLT
2014,mne,Montenegro,0,29030,-29030,MNE
2014,nld,Países Bajos,4254307,6378163,-2123856,NLD
2014,nor,Noruega,2885396,585447,2299949,NOR
2014,pol,Polonia,36366462,81328670,-44962208,POL
2014,prt,Portugal,6096992,9741194,-3644202,PRT
2014,rou,Rumania,40718547,27022666,13695881,ROU
2014,rus,Rusia,132000075,309916,131690159,RUS
2014,smr,San Marino,0,5360,-5360,SMR
2014,srb,Serbia,97,186834,-186737,SRB
2014,svk,Eslovaquia,4321949,45776280,-41454331,SVK
2014,svn,Eslovenia,1053323,1780890,-727567,SVN
2014,swe,Suecia,46199446,61421496,-15222050,SWE
2014,ukr,Ucrania,1745816,101571,1644245,UKR
2014,yug,Yugoslavia,0,4000,-4000,YUG
2014,abw,Aruba,3936037,52726,3883311,ABW
2014,atg,Antigua y Barbuda,73412,882,72530,ATG
2014,bmu,Bermuda,4977,24734,-19757,BMU
2014,brb,Barbados,170540,16,170524,BRB
2014,can,Canadá,4000306333,1519722224,2480584109,CAN
2014,cri,Costa Rica,61911656,4087724,57823932,CRI
2014,cub,Cuba,1416716,173284,1243432,CUB
2014,cym,Islas Caimán,134070,210,133860,CYM
2014,dma,Dominica,0,44,-44,DMA
2014,dom,República Dominicana,29102432,371655,28730777,DOM
2014,grl,Groenlandia,0,17,-17,GRL
2014,gtm,Guatemala,56266010,126737,56139273,GTM
2014,hnd,Honduras,24703173,14907016,9796157,HND
2014,msr,Montserrat,0,76,-76,MSR
2014,nic,Nicaragua,22029153,5,22029148,NIC
2014,pan,Panamá,94302901,136772,94166129,PAN
2014,pri,Puerto Rico,60968969,35807,60933162,PRI
2014,slv,El Salvador,22066285,8363,22057922,SLV
2014,tto,Trinidad y Tobago,5656547,565,5655982,TTO
2014,usa,Estados Unidos,70123366305,19525666813,50597699492,USA
2014,vir,Islas Vírgenes,0,158,-158,VIR
2014,aus,Australia,167958487,5337990,162620497,AUS
2014,cok,Islas Cook,0,226,-226,COK
2014,kir,Kiribati,0,4,-4,KIR
2014,ncl,Nueva Caledonia,46707,576,46131,NCL
2014,nzl,Nueva Zelandia,21659136,91603,21567533,NZL
2014,plw,Palau,0,16259,-16259,PLW
2014,tkl,Tokelau,0,4549,-4549,TKL
2014,wsm,Samoa,0,183454,-183454,WSM
2014,arg,Argentina,419723351,293179395,126543956,ARG
2014,bra,Brasil,1987687591,658713803,1328973788,BRA
2014,chl,Chile,336694341,1873998,334820343,CHL
2014,col,Colombia,1457893619,164448090,1293445529,COL
2014,ecu,Ecuador,173425467,52361,173373106,ECU
2014,guy,Guayana,223485,20,223465,GUY
2014,per,Perú,283088062,124664,282963398,PER
2014,pry,Paraguay,21248428,7163,21241265,PRY
2014,ury,Uruguay,113471068,9878,113461190,URY
2014,ven,Venezuela,98035888,143189,97892699,VEN
2014,ago,Angola,491291,0,491291,AGO
2014,dza,Argelia,133292,0,133292,DZA
2014,eth,Etiopía,64908,0,64908,ETH
2014,gab,Gabón,177720,0,177720,GAB
2014,mdg,Madagascar,115677,0,115677,MDG
2014,mus,Mauricio,939499,0,939499,MUS
2014,arm,Armenia,78553,0,78553,ARM
2014,bhr,Bahrein,3084750,0,3084750,BHR
2014,brn,Brunéi,1531849,0,1531849,BRN
2014,kaz,Kazajstán,136,0,136,KAZ
2014,kwt,Kuwait,21464580,0,21464580,KWT
2014,mmr,Birmania,73970,0,73970,MMR
2014,pse,Palestina,476730,0,476730,PSE
2014,yem,Yemen,861661,0,861661,YEM
2014,mda,Moldavia,9,0,9,MDA
2014,mkd,Macedonia del Norte,9839,0,9839,MKD
2014,bhs,Las Bahamas,1531465,0,1531465,BHS
2014,blz,Belice,1158163,0,1158163,BLZ
2014,cuw,Curaçao,811855,0,811855,CUW
2014,hti,Haití,5696866,0,5696866,HTI
2014,jam,Jamaica,1818210,0,1818210,JAM
2014,lca,Santa Lucía,54433,0,54433,LCA
2014,tca,Turcas y Caicos,589877,0,589877,TCA
2014,vgb,Islas Vírgenes Británicas,11443,0,11443,VGB
2014,glp,Guadalupe,819936,0,819936,GLP
2014,mtq,Martinica,181122,0,181122,MTQ
2014,fsm,Micronesia,9884,0,9884,FSM
2014,bol,Bolivia,54426564,0,54426564,BOL
2014,sur,Suriname,169512,0,169512,SUR
2014,guf,Guayana Francesa,2796417,0,2796417,GUF
2013,bfa,Burkina Faso,0,132,-132,BFA
2013,caf,República Centroafricana,0,3254,-3254,CAF
2013,civ,Côte d'Ivoire,0,585,-585,CIV
2013,cmr,Camerún,982,2107,-1125,CMR
2013,cog,"Congo, República del",225732,896,224836,COG
2013,cpv,Cabo Verde,0,56,-56,CPV
2013,dji,Djibouti,0,35,-35,DJI
2013,egy,Egipto,3370616,40353,3330263,EGY
2013,esh,Sahara Occidental,0,6390,-6390,ESH
2013,gab,Gabón,0,381,-381,GAB
2013,gha,Ghana,0,246,-246,GHA
2013,gmb,Gambia,0,52475,-52475,GMB
2013,gnb,Guinea-Bissau,0,7123,-7123,GNB
2013,ken,Kenia,223635,673429,-449794,KEN
2013,mar,Marruecos,1743756,18474,1725282,MAR
2013,mdg,Madagascar,19383,1339,18044,MDG
2013,mli,Malí,0,23,-23,MLI
2013,moz,Mozambique,0,557,-557,MOZ
2013,mus,Mauricio,314436,3954,310482,MUS
2013,mwi,Malawi,0,2984,-2984,MWI
2013,nam,Namibia,0,1237,-1237,NAM
2013,nga,Nigeria,765191,37194,727997,NGA
2013,reu,Réunion,0,35,-35,REU
2013,sen,Senegal,0,20262,-20262,SEN
2013,sle,Sierra Leona,0,524,-524,SLE
2013,swz,Esuatini,0,7414,-7414,SWZ
2013,tun,Túnez,0,89764,-89764,TUN
2013,uga,Uganda,2319,98,2221,UGA
2013,zaf,Sudáfrica,59243485,32509271,26734214,ZAF
2013,zwe,Zimbabue,743054,73706,669348,ZWE
2013,afg,Afganistán,1587,63007,-61420,AFG
2013,are,Emiratos Árabes Unidos,246322985,9065,246313920,ARE
2013,bgd,Bangladesh,0,100,-100,BGD
2013,cck,Islas Cocos (Keeling),0,135,-135,CCK
2013,chn,China,1613573268,1564962869,48610399,CHN
2013,cyp,Chipre,1191749,6928,1184821,CYP
2013,geo,Georgia,0,995,-995,GEO
2013,hkg,Hong Kong,11710062,1606744,10103318,HKG
2013,idn,Indonesia,14593589,79572059,-64978470,IDN
2013,ind,India,29296113,520471770,-491175657,IND
2013,irn,Irán,0,1803,-1803,IRN
2013,isr,Israel,14120804,494376,13626428,ISR
2013,jor,Jordania,13871614,217,13871397,JOR
2013,jpn,Japón,215831493,3345300406,-3129468913,JPN
2013,kaz,Kazajstán,91195,95,91100,KAZ
2013,kgz,Kirguistán,0,2232,-2232,KGZ
2013,khm,Camboya,270,1136387,-1136117,KHM
2013,kor,Corea del Sur,173659291,1189395115,-1015735824,KOR
2013,lka,Sri Lanka,107039,237171,-130132,LKA
2013,mac,Macau,0,221711,-221711,MAC
2013,mys,Malasia,43391938,7779917,35612021,MYS
2013,npl,Nepal,0,41,-41,NPL
2013,omn,Omán,18807714,6777105,12030609,OMN
2013,pak,Pakistán,0,205347,-205347,PAK
2013,phl,Filipinas,1949081,3619929,-1670848,PHL
2013,prk,Corea del Norte,0,342109,-342109,PRK
2013,pse,Palestina,0,96,-96,PSE
2013,qat,Katar,29775903,265,29775638,QAT
2013,sau,Arabia Saudita,111842888,12489,111830399,SAU
2013,sgp,Singapur,23622098,9750617,13871481,SGP
2013,syr,Siria,0,379,-379,SYR
2013,tha,Tailandia,119490789,382733873,-263243084,THA
2013,tjk,Tayikistán,0,823,-823,TJK
2013,tkm,Turkmenistán,0,814,-814,TKM
2013,tur,Turquía,70165268,63824938,6340330,TUR
2013,twn,Taiwan,7415172,163212960,-155797788,TWN
2013,uzb,Uzbekistán,1475780,1086,1474694,UZB
2013,vnm,Vietnam,1287210,23581050,-22293840,VNM
2013,yem,Yemen,735609,35,735574,YEM
2013,alb,Albania,0,162154,-162154,ALB
2013,and,Andorra,0,364,-364,AND
2013,ant,Antillas Holandesas,2951018,9370,2941648,ANT
2013,aut,Austria,26068068,83721648,-57653580,AUT
2013,bel,Bélgica,57579329,104874757,-47295428,BEL
2013,bgr,Bulgaria,390196,3288001,-2897805,BGR
2013,bih,Bosnia y Herzegovina,0,729391,-729391,BIH
2013,blr,Bielorrusia,0,36648,-36648,BLR
2013,che,Suiza,30239873,3545592,26694281,CHE
2013,cze,Chequia,6314430,109149392,-102834962,CZE
2013,deu,Alemania,2220515711,2167775579,52740132,DEU
2013,dnk,Dinamarca,15019,3139378,-3124359,DNK
2013,emu,Comunidad Europea,5468316,106510,5361806,EMU
2013,esp,España,31557140,533715905,-502158765,ESP
2013,est,Estonia,300245,6465905,-6165660,EST
2013,fin,Finlandia,46118484,5428620,40689864,FIN
2013,fra,Francia,52065129,232723428,-180658299,FRA
2013,gbr,Reino Unido,75417115,251498377,-176081262,GBR
2013,gib,Gibraltar,0,1410,-1410,GIB
2013,grc,Grecia,55095,1023439,-968344,GRC
2013,hrv,Croacia,0,379551,-379551,HRV
2013,hun,Hungría,12092042,97620939,-85528897,HUN
2013,irl,Irlanda,26182,581435,-555253,IRL
2013,isl,Islandia,273,260,13,ISL
2013,ita,Italia,278127353,336603091,-58475738,ITA
2013,lie,Liechtenstein,1888906,17270542,-15381636,LIE
2013,ltu,Lituania,5594488,101471,5493017,LTU
2013,lux,Luxemburgo,50724,1198371,-1147647,LUX
2013,lva,Letonia,0,40121,-40121,LVA
2013,mco,Mónaco,0,11736,-11736,MCO
2013,mda,Moldavia,0,40,-40,MDA
2013,mkd,Macedonia del Norte,0,21,-21,MKD
2013,mlt,Malta,180156,1497,178659,MLT
2013,nld,Países Bajos,10593803,4335670,6258133,NLD
2013,nor,Noruega,345486,1162021,-816535,NOR
2013,pol,Polonia,18511083,60517191,-42006108,POL
2013,prt,Portugal,3340132,16238147,-12898015,PRT
2013,rou,Rumania,27466727,19725884,7740843,ROU
2013,rus,Rusia,261646871,106992,261539879,RUS
2013,smr,San Marino,0,4268,-4268,SMR
2013,srb,Serbia,49905,118923,-69018,SRB
2013,svk,Eslovaquia,3086498,25833582,-22747084,SVK
2013,svn,Eslovenia,502199,1653954,-1151755,SVN
2013,swe,Suecia,30801835,87198629,-56396794,SWE
2013,ukr,Ucrania,25415770,53245,25362525,UKR
2013,vat,Ciudad del Vaticano,0,44,-44,VAT
2013,yug,Yugoslavia,0,28,-28,YUG
2013,abw,Aruba,7025558,22433,7003125,ABW
2013,atg,Antigua y Barbuda,406817,1482,405335,ATG
2013,bhs,Las Bahamas,1946216,12,1946204,BHS
2013,blz,Belice,1446567,872,1445695,BLZ
2013,brb,Barbados,682407,671,681736,BRB
2013,can,Canadá,3182231688,1615460484,1566771204,CAN
2013,cri,Costa Rica,51817578,2720432,49097146,CRI
2013,dom,República Dominicana,24167099,247974,23919125,DOM
2013,gtm,Guatemala,41339769,648049,40691720,GTM
2013,hnd,Honduras,21730058,7868043,13862015,HND
2013,nic,Nicaragua,22032892,91,22032801,NIC
2013,pan,Panamá,87852478,3412,87849066,PAN
2013,pri,Puerto Rico,74744577,110375,74634202,PRI
2013,slv,El Salvador,23336560,6105,23330455,SLV
2013,tca,Turcas y Caicos,420644,116,420528,TCA
2013,usa,Estados Unidos,61798883004,18350755695,43448127309,USA
2013,mtq,Martinica,129361,37,129324,MTQ
2013,pcz,Zona del Canal de Panamá,0,2674,-2674,PCZ
2013,aus,Australia,186619260,10626263,175992997,AUS
2013,cok,Islas Cook,0,37,-37,COK
2013,fsm,Micronesia,0,824,-824,FSM
2013,kir,Kiribati,0,83,-83,KIR
2013,mhl,Islas Marshall,0,167,-167,MHL
2013,ncl,Nueva Caledonia,160312,2974,157338,NCL
2013,nru,Nauru,0,13,-13,NRU
2013,nzl,Nueva Zelandia,19564737,53115,19511622,NZL
2013,plw,Palau,0,105419,-105419,PLW
2013,tkl,Tokelau,0,829,-829,TKL
2013,ton,Tonga,0,98,-98,TON
2013,vut,Vanuatu,0,15,-15,VUT
2013,wsm,Samoa,0,765,-765,WSM
2013,arg,Argentina,891922018,306916619,585005399,ARG
2013,bol,Bolivia,35178196,87,35178109,BOL
2013,bra,Brasil,2376974301,817474910,1559499391,BRA
2013,chl,Chile,429145197,6389764,422755433,CHL
2013,col,Colombia,1013781792,190351238,823430554,COL
2013,ecu,Ecuador,179892000,4199,179887801,ECU
2013,per,Perú,358041304,104201,357937103,PER
2013,ury,Uruguay,104980876,53425,104927451,URY
2013,ven,Venezuela,50182542,247316,49935226,VEN
2013,guf,Guayana Francesa,1704387,432,1703955,GUF
2013,ago,Angola,689374,0,689374,AGO
2013,eri,Eritrea,87119,0,87119,ERI
2013,lby,Libia,9776672,0,9776672,LBY
2013,zmb,Zambia,3567,0,3567,ZMB
2013,arm,Armenia,144561,0,144561,ARM
2013,aze,Azerbaiyán,146078,0,146078,AZE
2013,bhr,Bahrein,11399325,0,11399325,BHR
2013,brn,Brunéi,2908490,0,2908490,BRN
2013,irq,Irak,3815750,0,3815750,IRQ
2013,kwt,Kuwait,48360501,0,48360501,KWT
2013,lbn,Líbano,609324,0,609324,LBN
2013,mmr,Birmania,290914,0,290914,MMR
2013,mng,Mongolia,341719,0,341719,MNG
2013,bmu,Bermuda,5415,0,5415,BMU
2013,cub,Cuba,1166476,0,1166476,CUB
2013,cuw,Curaçao,1397272,0,1397272,CUW
2013,cym,Islas Caimán,5673,0,5673,CYM
2013,grd,Granada,7943,0,7943,GRD
2013,hti,Haití,3932509,0,3932509,HTI
2013,jam,Jamaica,2378918,0,2378918,JAM
2013,lca,Santa Lucía,27727,0,27727,LCA
2013,tto,Trinidad y Tobago,4043461,0,4043461,TTO
2013,vgb,Islas Vírgenes Británicas,68352,0,68352,VGB
2013,glp,Guadalupe,716884,0,716884,GLP
2013,guy,Guayana,750230,0,750230,GUY
2013,pry,Paraguay,13967060,0,13967060,PRY
2013,sur,Suriname,1119426,0,1119426,SUR
2012,ago,Angola,719487,132,719355,AGO
2012,bfa,Burkina Faso,0,950,-950,BFA
2012,caf,República Centroafricana,0,7113,-7113,CAF
2012,civ,Côte d'Ivoire,0,1454,-1454,CIV
2012,cmr,Camerún,0,1009,-1009,CMR
2012,egy,Egipto,6428530,23504,6405026,EGY
2012,eth,Etiopía,0,89,-89,ETH
2012,gha,Ghana,379677,141,379536,GHA
2012,gin,Guinea,0,60,-60,GIN
2012,gmb,Gambia,0,4676,-4676,GMB
2012,gnq,Guinea Ecuatorial,0,318,-318,GNQ
2012,mar,Marruecos,3829114,3205,3825909,MAR
2012,mli,Malí,0,30431,-30431,MLI
2012,moz,Mozambique,99170,1604,97566,MOZ
2012,mus,Mauricio,76058,5644,70414,MUS
2012,nam,Namibia,0,108,-108,NAM
2012,ner,Níger,8956,442,8514,NER
2012,nga,Nigeria,5281956,19032,5262924,NGA
2012,reu,Réunion,79022,15999,63023,REU
2012,sen,Senegal,0,11558,-11558,SEN
2012,sle,Sierra Leona,0,1049,-1049,SLE
2012,swz,Esuatini,23710,26074,-2364,SWZ
2012,tun,Túnez,4281313,99114,4182199,TUN
2012,tza,Tanzania,9401,404,8997,TZA
2012,uga,Uganda,1069323,78,1069245,UGA
2012,zaf,Sudáfrica,73701930,38269035,35432895,ZAF
2012,zmb,Zambia,3104,1047,2057,ZMB
2012,zwe,Zimbabue,834859,102,834757,ZWE
2012,afg,Afganistán,0,114943,-114943,AFG
2012,are,Emiratos Árabes Unidos,297303885,316873,296987012,ARE
2012,aze,Azerbaiyán,533106,16,533090,AZE
2012,bgd,Bangladesh,5284,26,5258,BGD
2012,cck,Islas Cocos (Keeling),3035,12,3023,CCK
2012,chn,China,935217844,1308878084,-373660240,CHN
2012,geo,Georgia,0,33591,-33591,GEO
2012,hkg,Hong Kong,26022766,1610754,24412012,HKG
2012,idn,Indonesia,12077993,77678625,-65600632,IDN
2012,ind,India,31059169,465181991,-434122822,IND
2012,irn,Irán,0,359,-359,IRN
2012,isr,Israel,9819988,1324047,8495941,ISR
2012,jor,Jordania,36717113,5174,36711939,JOR
2012,jpn,Japón,288153435,3430029641,-3141876206,JPN
2012,kaz,Kazajstán,89353,1299,88054,KAZ
2012,khm,Camboya,0,863167,-863167,KHM
2012,kor,Corea del Sur,114796656,1320355041,-1205558385,KOR
2012,lao,Laos,0,225,-225,LAO
2012,lbn,Líbano,7277310,465,7276845,LBN
2012,lka,Sri Lanka,0,223455,-223455,LKA
2012,mac,Macau,0,161050,-161050,MAC
2012,mmr,Birmania,0,502,-502,MMR
2012,mng,Mongolia,3998,8,3990,MNG
2012,mys,Malasia,34948725,7117726,27830999,MYS
2012,npl,Nepal,0,227,-227,NPL
2012,omn,Omán,21692931,1885523,19807408,OMN
2012,pak,Pakistán,1301,950118,-948817,PAK
2012,phl,Filipinas,751463,2975561,-2224098,PHL
2012,prk,Corea del Norte,5529,157973,-152444,PRK
2012,sau,Arabia Saudita,26126000,98303,26027697,SAU
2012,sgp,Singapur,45985207,6683487,39301720,SGP
2012,syr,Siria,0,624,-624,SYR
2012,tha,Tailandia,154623195,411735093,-257111898,THA
2012,tjk,Tayikistán,0,141,-141,TJK
2012,tur,Turquía,62419212,52304491,10114721,TUR
2012,twn,Taiwan,19869264,182544772,-162675508,TWN
2012,uzb,Uzbekistán,400972,105,400867,UZB
2012,vnm,Vietnam,454805,14771359,-14316554,VNM
2012,alb,Albania,0,495,-495,ALB
2012,ant,Antillas Holandesas,954420,6271,948149,ANT
2012,aut,Austria,17824677,70118922,-52294245,AUT
2012,bel,Bélgica,41696766,94951196,-53254430,BEL
2012,bgr,Bulgaria,266248,2113221,-1846973,BGR
2012,bih,Bosnia y Herzegovina,0,351703,-351703,BIH
2012,blr,Bielorrusia,0,91,-91,BLR
2012,che,Suiza,25769513,3727754,22041759,CHE
2012,cze,Chequia,8702750,54102895,-45400145,CZE
2012,deu,Alemania,3077457865,2339445727,738012138,DEU
2012,dnk,Dinamarca,62984,2136809,-2073825,DNK
2012,emu,Comunidad Europea,11416868,87246,11329622,EMU
2012,esp,España,39381723,496806363,-457424640,ESP
2012,est,Estonia,269172,2697361,-2428189,EST
2012,fin,Finlandia,48184957,29195959,18988998,FIN
2012,fra,Francia,44128793,191128917,-147000124,FRA
2012,gbr,Reino Unido,77461087,225017862,-147556775,GBR
2012,gib,Gibraltar,0,1906,-1906,GIB
2012,grc,Grecia,220206,779302,-559096,GRC
2012,hrv,Croacia,0,550445,-550445,HRV
2012,hun,Hungría,1505563,43853384,-42347821,HUN
2012,irl,Irlanda,33798,1303058,-1269260,IRL
2012,ita,Italia,529750546,263254983,266495563,ITA
2012,lie,Liechtenstein,805342,9665943,-8860601,LIE
2012,ltu,Lituania,2060946,38618,2022328,LTU
2012,lux,Luxemburgo,94508,47812,46696,LUX
2012,lva,Letonia,213698,3005,210693,LVA
2012,mco,Mónaco,0,27132,-27132,MCO
2012,mda,Moldavia,0,20,-20,MDA
2012,mkd,Macedonia del Norte,0,1487,-1487,MKD
2012,nld,Países Bajos,26077853,4264810,21813043,NLD
2012,nor,Noruega,935320,445135,490185,NOR
2012,pol,Polonia,6637991,80324339,-73686348,POL
2012,prt,Portugal,983725,14060156,-13076431,PRT
2012,rou,Rumania,9217621,16652478,-7434857,ROU
2012,rus,Rusia,226922016,53130,226868886,RUS
2012,sjm,Svalbard y Jan Mayen,0,258,-258,SJM
2012,smr,San Marino,0,4794,-4794,SMR
2012,srb,Serbia,0,4353,-4353,SRB
2012,svk,Eslovaquia,7393905,24095754,-16701849,SVK
2012,svn,Eslovenia,1574154,1486083,88071,SVN
2012,swe,Suecia,12480573,114836243,-102355670,SWE
2012,ukr,Ucrania,27651085,29190,27621895,UKR
2012,vat,Ciudad del Vaticano,0,567,-567,VAT
2012,yug,Yugoslavia,0,1499,-1499,YUG
2012,abw,Aruba,3267385,55932,3211453,ABW
2012,atg,Antigua y Barbuda,14688,1788,12900,ATG
2012,blz,Belice,817480,333,817147,BLZ
2012,brb,Barbados,957521,253,957268,BRB
2012,can,Canadá,3005326750,1607012149,1398314601,CAN
2012,cri,Costa Rica,61577647,974569,60603078,CRI
2012,cub,Cuba,1107867,1722,1106145,CUB
2012,cym,Islas Caimán,77506,62,77444,CYM
2012,dom,República Dominicana,20036975,205021,19831954,DOM
2012,gtm,Guatemala,51994952,908816,51086136,GTM
2012,hnd,Honduras,35877848,4842578,31035270,HND
2012,hti,Haití,2115700,14,2115686,HTI
2012,lca,Santa Lucía,22482,46,22436,LCA
2012,msr,Montserrat,0,1436,-1436,MSR
2012,nic,Nicaragua,33036045,744,33035301,NIC
2012,pan,Panamá,90799416,27770,90771646,PAN
2012,pri,Puerto Rico,68857597,58972,68798625,PRI
2012,slv,El Salvador,24561294,133167,24428127,SLV
2012,tca,Turcas y Caicos,631402,246,631156,TCA
2012,tto,Trinidad y Tobago,1723834,98,1723736,TTO
2012,usa,Estados Unidos,53322526528,17867264792,35455261736,USA
2012,vct,San Vicente y las Granadinas,0,1046,-1046,VCT
2012,vgb,Islas Vírgenes Británicas,105201,27521,77680,VGB
2012,pcz,Zona del Canal de Panamá,11,2250,-2239,PCZ
2012,aus,Australia,199058409,5505796,193552613,AUS
2012,fsm,Micronesia,5912,2875,3037,FSM
2012,ncl,Nueva Caledonia,23360,2739,20621,NCL
2012,nru,Nauru,0,87,-87,NRU
2012,nzl,Nueva Zelandia,22704335,53974,22650361,NZL
2012,pcn,Islas Pitcairn,0,63,-63,PCN
2012,plw,Palau,0,52394,-52394,PLW
2012,tkl,Tokelau,0,3261,-3261,TKL
2012,vut,Vanuatu,0,9,-9,VUT
2012,wlf,Wallis y Futuna,0,210,-210,WLF
2012,wsm,Samoa,0,34,-34,WSM
2012,arg,Argentina,835475927,146394221,689081706,ARG
2012,bra,Brasil,2866045632,773557901,2092487731,BRA
2012,chl,Chile,558044928,5058550,552986378,CHL
2012,col,Colombia,1606659810,145630815,1461028995,COL
2012,ecu,Ecuador,158607891,3714,158604177,ECU
2012,flk,Islas Malvinas,0,120,-120,FLK
2012,per,Perú,404450653,191076,404259577,PER
2012,pry,Paraguay,7577207,12,7577195,PRY
2012,sur,Suriname,4492417,474,4491943,SUR
2012,ury,Uruguay,94315941,89861,94226080,URY
2012,ven,Venezuela,83281227,740738,82540489,VEN
2012,guf,Guayana Francesa,3346551,204,3346347,GUF
2012,gab,Gabón,839,0,839,GAB
2012,ken,Kenia,108254,0,108254,KEN
2012,lby,Libia,16687216,0,16687216,LBY
2012,sdn,Sudán,3625,0,3625,SDN
2012,arm,Armenia,102525,0,102525,ARM
2012,bhr,Bahrein,24477800,0,24477800,BHR
2012,brn,Brunéi,2159127,0,2159127,BRN
2012,cyp,Chipre,1157750,0,1157750,CYP
2012,kwt,Kuwait,73746567,0,73746567,KWT
2012,qat,Katar,39555909,0,39555909,QAT
2012,yem,Yemen,261940,0,261940,YEM
2012,isl,Islandia,636,0,636,ISL
2012,mlt,Malta,178649,0,178649,MLT
2012,bhs,Las Bahamas,2232338,0,2232338,BHS
2012,bmu,Bermuda,4,0,4,BMU
2012,cuw,Curaçao,918460,0,918460,CUW
2012,dma,Dominica,275,0,275,DMA
2012,grd,Granada,24760,0,24760,GRD
2012,jam,Jamaica,431910,0,431910,JAM
2012,glp,Guadalupe,344403,0,344403,GLP
2012,pyf,Polinesia francés,67404,0,67404,PYF
2012,bol,Bolivia,40979886,0,40979886,BOL
2012,guy,Guayana,9080,0,9080,GUY
2011,ago,Angola,132118,78,132040,AGO
2011,bfa,Burkina Faso,0,130,-130,BFA
2011,caf,República Centroafricana,0,790,-790,CAF
2011,civ,Côte d'Ivoire,58158,11577,46581,CIV
2011,cmr,Camerún,82734,6383,76351,CMR
2011,cog,"Congo, República del",0,3028,-3028,COG
2011,egy,Egipto,4137529,230462,3907067,EGY
2011,gha,Ghana,0,3300,-3300,GHA
2011,mar,Marruecos,5288,448926,-443638,MAR
2011,mdg,Madagascar,118799,2068,116731,MDG
2011,moz,Mozambique,264004,324,263680,MOZ
2011,mus,Mauricio,354523,300,354223,MUS
2011,mwi,Malawi,0,322,-322,MWI
2011,nam,Namibia,0,16,-16,NAM
2011,ner,Níger,0,40,-40,NER
2011,nga,Nigeria,1910792,35000,1875792,NGA
2011,reu,Réunion,0,342,-342,REU
2011,sen,Senegal,0,13222,-13222,SEN
2011,shn,Santa Elena,0,35598,-35598,SHN
2011,sle,Sierra Leona,0,40,-40,SLE
2011,swz,Esuatini,0,273,-273,SWZ
2011,tun,Túnez,6936345,44565,6891780,TUN
2011,tza,Tanzania,0,106,-106,TZA
2011,uga,Uganda,18,39,-21,UGA
2011,zaf,Sudáfrica,67672873,22949846,44723027,ZAF
2011,zmb,Zambia,27928,2781,25147,ZMB
2011,afg,Afganistán,0,8878,-8878,AFG
2011,are,Emiratos Árabes Unidos,97373052,5763,97367289,ARE
2011,aze,Azerbaiyán,1018615,129,1018486,AZE
2011,btn,Bhutan,0,1222,-1222,BTN
2011,chn,China,891008942,997908696,-106899754,CHN
2011,cyp,Chipre,788813,5010,783803,CYP
2011,geo,Georgia,0,19466,-19466,GEO
2011,hkg,Hong Kong,6987156,994315,5992841,HKG
2011,idn,Indonesia,1518567,49586886,-48068319,IDN
2011,ind,India,22645070,273559235,-250914165,IND
2011,irn,Irán,0,6018,-6018,IRN
2011,isr,Israel,11786858,16019565,-4232707,ISR
2011,jor,Jordania,5546905,696,5546209,JOR
2011,jpn,Japón,207813145,3411069728,-3203256583,JPN
2011,khm,Camboya,0,209226,-209226,KHM
2011,kor,Corea del Sur,103862299,1036820315,-932958016,KOR
2011,lbn,Líbano,13792587,652,13791935,LBN
2011,lka,Sri Lanka,9307,200565,-191258,LKA
2011,mac,Macau,0,152390,-152390,MAC
2011,mys,Malasia,15851207,5804118,10047089,MYS
2011,npl,Nepal,0,33,-33,NPL
2011,omn,Omán,9374852,500095,8874757,OMN
2011,pak,Pakistán,308630,700343,-391713,PAK
2011,phl,Filipinas,525601,3149189,-2623588,PHL
2011,prk,Corea del Norte,259624,262498,-2874,PRK
2011,qat,Katar,21391153,10811,21380342,QAT
2011,sau,Arabia Saudita,11396365,79097,11317268,SAU
2011,sgp,Singapur,40931648,6479557,34452091,SGP
2011,syr,Siria,0,10,-10,SYR
2011,tha,Tailandia,79018567,145222730,-66204163,THA
2011,tur,Turquía,21162077,40423992,-19261915,TUR
2011,twn,Taiwan,20935319,152415324,-131480005,TWN
2011,uzb,Uzbekistán,0,37,-37,UZB
2011,vnm,Vietnam,161219,11652149,-11490930,VNM
2011,alb,Albania,0,34,-34,ALB
2011,and,Andorra,0,151,-151,AND
2011,ant,Antillas Holandesas,2169233,6515,2162718,ANT
2011,aut,Austria,4264869,62060080,-57795211,AUT
2011,bel,Bélgica,29947110,77677227,-47730117,BEL
2011,bgr,Bulgaria,0,770954,-770954,BGR
2011,bih,Bosnia y Herzegovina,0,60589,-60589,BIH
2011,blr,Bielorrusia,0,10381,-10381,BLR
2011,che,Suiza,10649152,5540693,5108459,CHE
2011,cze,Chequia,5429291,36976192,-31546901,CZE
2011,deu,Alemania,2974698413,2065836599,908861814,DEU
2011,dnk,Dinamarca,106835,799597,-692762,DNK
2011,emu,Comunidad Europea,2464583,1927073,537510,EMU
2011,esp,España,11644605,370446785,-358802180,ESP
2011,est,Estonia,75339,1181986,-1106647,EST
2011,fin,Finlandia,40665140,3894128,36771012,FIN
2011,fra,Francia,21351980,199527007,-178175027,FRA
2011,gbr,Reino Unido,86344375,175012022,-88667647,GBR
2011,gib,Gibraltar,0,71,-71,GIB
2011,grc,Grecia,0,480337,-480337,GRC
2011,hrv,Croacia,0,375244,-375244,HRV
2011,hun,Hungría,1781964,26910275,-25128311,HUN
2011,irl,Irlanda,28615,974692,-946077,IRL
2011,ita,Italia,555776863,232104235,323672628,ITA
2011,lie,Liechtenstein,657892,6741195,-6083303,LIE
2011,ltu,Lituania,2070735,30599,2040136,LTU
2011,lux,Luxemburgo,0,318354,-318354,LUX
2011,lva,Letonia,206,779,-573,LVA
2011,mco,Mónaco,85,50699,-50614,MCO
2011,mda,Moldavia,0,37,-37,MDA
2011,mkd,Macedonia del Norte,4351,2718,1633,MKD
2011,mlt,Malta,173788,2084,171704,MLT
2011,mne,Montenegro,0,144,-144,MNE
2011,nld,Países Bajos,38948564,7126711,31821853,NLD
2011,nor,Noruega,472960,554259,-81299,NOR
2011,pol,Polonia,8571965,56679984,-48108019,POL
2011,prt,Portugal,2077428,9520349,-7442921,PRT
2011,rou,Rumania,991807,17731896,-16740089,ROU
2011,rus,Rusia,271503836,97800,271406036,RUS
2011,srb,Serbia,0,5079,-5079,SRB
2011,svk,Eslovaquia,4670435,20241307,-15570872,SVK
2011,svn,Eslovenia,10084511,1262760,8821751,SVN
2011,swe,Suecia,7279344,114338912,-107059568,SWE
2011,ukr,Ucrania,28443728,40493,28403235,UKR
2011,vat,Ciudad del Vaticano,0,18730,-18730,VAT
2011,abw,Aruba,2585362,382616,2202746,ABW
2011,aia,Anguilla,0,1630,-1630,AIA
2011,atg,Antigua y Barbuda,107248,1478,105770,ATG
2011,bhs,Las Bahamas,974056,1169,972887,BHS
2011,blz,Belice,1703936,35999,1667937,BLZ
2011,brb,Barbados,225034,15,225019,BRB
2011,can,Canadá,2985967527,1455310317,1530657210,CAN
2011,cri,Costa Rica,65620247,594024,65026223,CRI
2011,cub,Cuba,1619586,401216,1218370,CUB
2011,cym,Islas Caimán,65322,39,65283,CYM
2011,dom,República Dominicana,17380809,168450,17212359,DOM
2011,gtm,Guatemala,40171479,252251,39919228,GTM
2011,hnd,Honduras,14886600,3179192,11707408,HND
2011,msr,Montserrat,0,27,-27,MSR
2011,nic,Nicaragua,30042594,1460,30041134,NIC
2011,pan,Panamá,77736756,24952,77711804,PAN
2011,pri,Puerto Rico,41547789,187196,41360593,PRI
2011,slv,El Salvador,14331663,22900,14308763,SLV
2011,tca,Turcas y Caicos,0,859,-859,TCA
2011,tto,Trinidad y Tobago,1032110,36,1032074,TTO
2011,usa,Estados Unidos,46984793811,15672408475,31312385336,USA
2011,vgb,Islas Vírgenes Británicas,24671,2883,21788,VGB
2011,glp,Guadalupe,91043,129,90914,GLP
2011,aus,Australia,175145875,3809545,171336330,AUS
2011,fji,Fiji,0,233,-233,FJI
2011,fsm,Micronesia,0,9513,-9513,FSM
2011,gum,Guam,0,375,-375,GUM
2011,mhl,Islas Marshall,0,524,-524,MHL
2011,ncl,Nueva Caledonia,0,784,-784,NCL
2011,nru,Nauru,0,50,-50,NRU
2011,nzl,Nueva Zelandia,16435205,28366,16406839,NZL
2011,plw,Palau,0,48528,-48528,PLW
2011,png,Papua Nueva Guinea,890923,3827,887096,PNG
2011,tkl,Tokelau,0,118542,-118542,TKL
2011,wsm,Samoa,0,225,-225,WSM
2011,arg,Argentina,942243713,265126905,677116808,ARG
2011,bra,Brasil,2548856341,897896653,1650959688,BRA
2011,chl,Chile,634430933,4688386,629742547,CHL
2011,col,Colombia,1882165926,2221590,1879944336,COL
2011,ecu,Ecuador,144019126,16486,144002640,ECU
2011,per,Perú,261570284,247019,261323265,PER
2011,sur,Suriname,142652,296,142356,SUR
2011,ury,Uruguay,106233211,237279,105995932,URY
2011,ven,Venezuela,35283899,1378433,33905466,VEN
2011,ben,Benin,24250,0,24250,BEN
2011,dza,Argelia,1499215,0,1499215,DZA
2011,eri,Eritrea,178212,0,178212,ERI
2011,gab,Gabón,19852,0,19852,GAB
2011,gin,Guinea,48780,0,48780,GIN
2011,arm,Armenia,90206,0,90206,ARM
2011,bhr,Bahrein,13444805,0,13444805,BHR
2011,brn,Brunéi,266352,0,266352,BRN
2011,kaz,Kazajstán,280044,0,280044,KAZ
2011,kwt,Kuwait,6661692,0,6661692,KWT
2011,mng,Mongolia,125000,0,125000,MNG
2011,pse,Palestina,102640,0,102640,PSE
2011,isl,Islandia,4395,0,4395,ISL
2011,bmu,Bermuda,8055,0,8055,BMU
2011,cuw,Curaçao,1923465,0,1923465,CUW
2011,grd,Granada,20580,0,20580,GRD
2011,hti,Haití,3981081,0,3981081,HTI
2011,jam,Jamaica,455121,0,455121,JAM
2011,lca,Santa Lucía,21445,0,21445,LCA
2011,vct,San Vicente y las Granadinas,347,0,347,VCT
2011,mtq,Martinica,406480,0,406480,MTQ
2011,pyf,Polinesia francés,72625,0,72625,PYF
2011,bol,Bolivia,15552194,0,15552194,BOL
2011,guy,Guayana,1986800,0,1986800,GUY
2011,pry,Paraguay,11046574,0,11046574,PRY
2011,guf,Guayana Francesa,520380,0,520380,GUF
2010,bwa,Botswana,0,7329,-7329,BWA
2010,caf,República Centroafricana,0,221,-221,CAF
2010,civ,Côte d'Ivoire,109527,9895,99632,CIV
2010,cmr,Camerún,53408,12533,40875,CMR
2010,cog,"Congo, República del",0,421,-421,COG
2010,egy,Egipto,11153398,12202,11141196,EGY
2010,eri,Eritrea,0,2716,-2716,ERI
2010,eth,Etiopía,0,178,-178,ETH
2010,gab,Gabón,0,4386,-4386,GAB
2010,mar,Marruecos,194352,969,193383,MAR
2010,mdg,Madagascar,200249,66,200183,MDG
2010,mli,Malí,0,425,-425,MLI
2010,moz,Mozambique,95940,47,95893,MOZ
2010,mus,Mauricio,0,26213,-26213,MUS
2010,mwi,Malawi,0,535,-535,MWI
2010,nam,Namibia,496,9,487,NAM
2010,nga,Nigeria,3412626,137,3412489,NGA
2010,reu,Réunion,0,12,-12,REU
2010,sen,Senegal,0,12961,-12961,SEN
2010,sle,Sierra Leona,0,1277,-1277,SLE
2010,som,Somalia,0,7691,-7691,SOM
2010,swz,Esuatini,0,897,-897,SWZ
2010,syc,Seychelles,0,123,-123,SYC
2010,tcd,Chad,0,928,-928,TCD
2010,tun,Túnez,5978027,13351,5964676,TUN
2010,zaf,Sudáfrica,24546517,12821435,11725082,ZAF
2010,zmb,Zambia,0,323,-323,ZMB
2010,atf,Francés Territorio Sur de la Antártida,0,58,-58,ATF
2010,afg,Afganistán,0,101,-101,AFG
2010,are,Emiratos Árabes Unidos,47433264,2190,47431074,ARE
2010,aze,Azerbaiyán,0,155,-155,AZE
2010,btn,Bhutan,0,631,-631,BTN
2010,chn,China,640401382,800244746,-159843364,CHN
2010,cyp,Chipre,932576,5955,926621,CYP
2010,geo,Georgia,0,15160,-15160,GEO
2010,hkg,Hong Kong,3281288,1543988,1737300,HKG
2010,idn,Indonesia,592925,13070492,-12477567,IDN
2010,ind,India,48708298,167376010,-118667712,IND
2010,irn,Irán,0,124,-124,IRN
2010,isr,Israel,22716388,832568,21883820,ISR
2010,jpn,Japón,211915081,3020279130,-2808364049,JPN
2010,khm,Camboya,0,493,-493,KHM
2010,kor,Corea del Sur,30718110,771530264,-740812154,KOR
2010,lbn,Líbano,5365107,93,5365014,LBN
2010,lka,Sri Lanka,0,61346,-61346,LKA
2010,mmr,Birmania,0,5,-5,MMR
2010,mys,Malasia,8791801,5322795,3469006,MYS
2010,pak,Pakistán,171399,206934,-35535,PAK
2010,phl,Filipinas,3723241,3252357,470884,PHL
2010,prk,Corea del Norte,768213,231989,536224,PRK
2010,sau,Arabia Saudita,18312325,5965,18306360,SAU
2010,sgp,Singapur,25770234,5553166,20217068,SGP
2010,syr,Siria,0,75,-75,SYR
2010,tha,Tailandia,44929574,89095758,-44166184,THA
2010,tjk,Tayikistán,0,157,-157,TJK
2010,tur,Turquía,17418848,38792029,-21373181,TUR
2010,twn,Taiwan,12418572,126620518,-114201946,TWN
2010,uzb,Uzbekistán,0,1636,-1636,UZB
2010,vnm,Vietnam,391291,4421934,-4030643,VNM
2010,alb,Albania,0,1371,-1371,ALB
2010,and,Andorra,0,214,-214,AND
2010,ant,Antillas Holandesas,1820602,2093,1818509,ANT
2010,aut,Austria,1063658,35083619,-34019961,AUT
2010,bel,Bélgica,51775069,34835571,16939498,BEL
2010,bgr,Bulgaria,0,3894,-3894,BGR
2010,bih,Bosnia y Herzegovina,0,3140,-3140,BIH
2010,blr,Bielorrusia,0,68,-68,BLR
2010,che,Suiza,7755235,5210845,2544390,CHE
2010,cze,Chequia,2740141,24728073,-21987932,CZE
2010,deu,Alemania,2344287403,1826421124,517866279,DEU
2010,dnk,Dinamarca,101124,956015,-854891,DNK
2010,emu,Comunidad Europea,1652466,80027,1572439,EMU
2010,esp,España,10509817,399317476,-388807659,ESP
2010,est,Estonia,0,369140,-369140,EST
2010,fin,Finlandia,9150085,776579,8373506,FIN
2010,fra,Francia,15687603,128057406,-112369803,FRA
2010,gbr,Reino Unido,50215771,170735138,-120519367,GBR
2010,gib,Gibraltar,0,115,-115,GIB
2010,grc,Grecia,615942,421490,194452,GRC
2010,hrv,Croacia,0,280227,-280227,HRV
2010,hun,Hungría,4146470,25710198,-21563728,HUN
2010,irl,Irlanda,51435,662438,-611003,IRL
2010,isl,Islandia,1761,511,1250,ISL
2010,ita,Italia,12863876,114243834,-101379958,ITA
2010,lie,Liechtenstein,351946,4451993,-4100047,LIE
2010,ltu,Lituania,1000,111043,-110043,LTU
2010,lux,Luxemburgo,0,497582,-497582,LUX
2010,lva,Letonia,0,1421,-1421,LVA
2010,mco,Mónaco,0,3869,-3869,MCO
2010,mda,Moldavia,0,5,-5,MDA
2010,mlt,Malta,2897,3683,-786,MLT
2010,nld,Países Bajos,12790595,5910733,6879862,NLD
2010,nor,Noruega,809489,1104922,-295433,NOR
2010,pol,Polonia,16069881,42073029,-26003148,POL
2010,prt,Portugal,1684242,4354955,-2670713,PRT
2010,rou,Rumania,69478,13699892,-13630414,ROU
2010,rus,Rusia,177601905,62587,177539318,RUS
2010,srb,Serbia,0,380,-380,SRB
2010,svk,Eslovaquia,3227845,16384083,-13156238,SVK
2010,svn,Eslovenia,2435779,749123,1686656,SVN
2010,swe,Suecia,13826474,86512579,-72686105,SWE
2010,ukr,Ucrania,20144416,22205,20122211,UKR
2010,abw,Aruba,1618690,559677,1059013,ABW
2010,aia,Anguilla,0,49360,-49360,AIA
2010,atg,Antigua y Barbuda,996,60,936,ATG
2010,bhs,Las Bahamas,414782,436,414346,BHS
2010,blz,Belice,381831,127,381704,BLZ
2010,can,Canadá,2320683067,1402514380,918168687,CAN
2010,cri,Costa Rica,42162842,459412,41703430,CRI
2010,dma,Dominica,253822,88,253734,DMA
2010,dom,República Dominicana,18148613,14470,18134143,DOM
2010,gtm,Guatemala,32624623,644981,31979642,GTM
2010,hnd,Honduras,6940104,2726484,4213620,HND
2010,lca,Santa Lucía,36377,20,36357,LCA
2010,pan,Panamá,39438212,228844,39209368,PAN
2010,pri,Puerto Rico,35134033,352749,34781284,PRI
2010,slv,El Salvador,9788006,9546,9778460,SLV
2010,tca,Turcas y Caicos,0,2195,-2195,TCA
2010,tto,Trinidad y Tobago,913397,398,912999,TTO
2010,usa,Estados Unidos,41015780715,12616080371,28399700344,USA
2010,vir,Islas Vírgenes,0,149,-149,VIR
2010,mtq,Martinica,79266,149,79117,MTQ
2010,aus,Australia,179583176,3973549,175609627,AUS
2010,cok,Islas Cook,0,2134,-2134,COK
2010,mhl,Islas Marshall,0,223,-223,MHL
2010,ncl,Nueva Caledonia,0,145,-145,NCL
2010,nzl,Nueva Zelandia,5297280,88338,5208942,NZL
2010,png,Papua Nueva Guinea,0,538,-538,PNG
2010,tkl,Tokelau,0,8236,-8236,TKL
2010,vut,Vanuatu,0,120,-120,VUT
2010,wsm,Samoa,0,916513,-916513,WSM
2010,arg,Argentina,943361465,339550802,603810663,ARG
2010,bol,Bolivia,10595726,186,10595540,BOL
2010,bra,Brasil,1517236721,1045239459,471997262,BRA
2010,chl,Chile,364563462,2053508,362509954,CHL
2010,col,Colombia,663177648,1226883,661950765,COL
2010,ecu,Ecuador,134159115,64938,134094177,ECU
2010,per,Perú,164843627,63767,164779860,PER
2010,pry,Paraguay,8980070,2366,8977704,PRY
2010,ury,Uruguay,83904042,610964,83293078,URY
2010,ven,Venezuela,55671331,1025856,54645475,VEN
2010,ago,Angola,576327,0,576327,AGO
2010,lby,Libia,383797,0,383797,LBY
2010,tza,Tanzania,82624,0,82624,TZA
2010,zwe,Zimbabue,65810,0,65810,ZWE
2010,bhr,Bahrein,52001873,0,52001873,BHR
2010,brn,Brunéi,129558,0,129558,BRN
2010,irq,Irak,25825,0,25825,IRQ
2010,jor,Jordania,1067445,0,1067445,JOR
2010,kwt,Kuwait,5559451,0,5559451,KWT
2010,mng,Mongolia,434763,0,434763,MNG
2010,omn,Omán,15596775,0,15596775,OMN
2010,qat,Katar,16966773,0,16966773,QAT
2010,bmu,Bermuda,50505,0,50505,BMU
2010,brb,Barbados,1295689,0,1295689,BRB
2010,cub,Cuba,1486523,0,1486523,CUB
2010,cuw,Curaçao,663680,0,663680,CUW
2010,cym,Islas Caimán,67587,0,67587,CYM
2010,grd,Granada,23148,0,23148,GRD
2010,hti,Haití,1908377,0,1908377,HTI
2010,jam,Jamaica,230342,0,230342,JAM
2010,nic,Nicaragua,6962444,0,6962444,NIC
2010,vct,San Vicente y las Granadinas,171,0,171,VCT
2010,vgb,Islas Vírgenes Británicas,121,0,121,VGB
2010,glp,Guadalupe,44293,0,44293,GLP
2010,pyf,Polinesia francés,20142,0,20142,PYF
2010,guy,Guayana,847582,0,847582,GUY
2010,sur,Suriname,348862,0,348862,SUR
2009,bfa,Burkina Faso,0,631,-631,BFA
2009,caf,República Centroafricana,0,297,-297,CAF
2009,civ,Côte d'Ivoire,12937,1459,11478,CIV
2009,cmr,Camerún,210454,2105,208349,CMR
2009,cog,"Congo, República del",0,35831,-35831,COG
2009,egy,Egipto,641110,13156,627954,EGY
2009,gab,Gabón,0,10165,-10165,GAB
2009,gha,Ghana,0,9291,-9291,GHA
2009,ken,Kenia,0,210,-210,KEN
2009,mar,Marruecos,0,621,-621,MAR
2009,mus,Mauricio,0,970,-970,MUS
2009,nam,Namibia,0,813,-813,NAM
2009,ner,Níger,0,3,-3,NER
2009,nga,Nigeria,38446,234,38212,NGA
2009,sen,Senegal,252770,15231,237539,SEN
2009,swz,Esuatini,0,279,-279,SWZ
2009,tun,Túnez,2985214,3714,2981500,TUN
2009,uga,Uganda,0,116,-116,UGA
2009,zaf,Sudáfrica,34968326,9612456,25355870,ZAF
2009,zmb,Zambia,0,1707,-1707,ZMB
2009,zwe,Zimbabue,0,34,-34,ZWE
2009,afg,Afganistán,0,1495,-1495,AFG
2009,are,Emiratos Árabes Unidos,2622885,146,2622739,ARE
2009,aze,Azerbaiyán,0,8,-8,AZE
2009,bgd,Bangladesh,0,7,-7,BGD
2009,chn,China,208683272,463062392,-254379120,CHN
2009,cxr,Isla de Navidad,0,25,-25,CXR
2009,geo,Georgia,0,686,-686,GEO
2009,hkg,Hong Kong,1717925,693292,1024633,HKG
2009,idn,Indonesia,4555080,14008149,-9453069,IDN
2009,ind,India,14662796,96652342,-81989546,IND
2009,iot,Territorio Británico del Océano Índico,0,86,-86,IOT
2009,irn,Irán,0,31,-31,IRN
2009,isr,Israel,26556677,227013,26329664,ISR
2009,jpn,Japón,190616381,1307797136,-1117180755,JPN
2009,khm,Camboya,0,22463,-22463,KHM
2009,kor,Corea del Sur,14088425,342634746,-328546321,KOR
2009,lka,Sri Lanka,0,126537,-126537,LKA
2009,mac,Macau,0,35,-35,MAC
2009,mys,Malasia,2383375,2939404,-556029,MYS
2009,pak,Pakistán,0,233107,-233107,PAK
2009,phl,Filipinas,88745,1472058,-1383313,PHL
2009,prk,Corea del Norte,171304,477566,-306262,PRK
2009,sau,Arabia Saudita,335176,370828,-35652,SAU
2009,sgp,Singapur,5798147,2407284,3390863,SGP
2009,tha,Tailandia,18028901,36446422,-18417521,THA
2009,tkm,Turkmenistán,0,556,-556,TKM
2009,tur,Turquía,228107,22103951,-21875844,TUR
2009,twn,Taiwan,425453,82645898,-82220445,TWN
2009,uzb,Uzbekistán,0,1743,-1743,UZB
2009,vnm,Vietnam,1222675,1783135,-560460,VNM
2009,and,Andorra,0,1018,-1018,AND
2009,ant,Antillas Holandesas,712158,2241,709917,ANT
2009,aut,Austria,659305,12863171,-12203866,AUT
2009,bel,Bélgica,10626215,23088139,-12461924,BEL
2009,bgr,Bulgaria,0,2814,-2814,BGR
2009,bih,Bosnia y Herzegovina,0,827,-827,BIH
2009,blr,Bielorrusia,0,51866,-51866,BLR
2009,che,Suiza,6614880,439061,6175819,CHE
2009,cze,Chequia,3572367,16706109,-13133742,CZE
2009,deu,Alemania,2122519617,1668103616,454416001,DEU
2009,dnk,Dinamarca,19317,617570,-598253,DNK
2009,emu,Comunidad Europea,1764353,56180,1708173,EMU
2009,esp,España,11621938,353410167,-341788229,ESP
2009,est,Estonia,40840,78694,-37854,EST
2009,fin,Finlandia,158255,2100769,-1942514,FIN
2009,fra,Francia,12826515,89001381,-76174866,FRA
2009,gbr,Reino Unido,23047398,120130241,-97082843,GBR
2009,gib,Gibraltar,0,20,-20,GIB
2009,grc,Grecia,273660,8706,264954,GRC
2009,hrv,Croacia,24702,159477,-134775,HRV
2009,hun,Hungría,316743,9828837,-9512094,HUN
2009,irl,Irlanda,14970,442217,-427247,IRL
2009,ita,Italia,28783197,80977308,-52194111,ITA
2009,lie,Liechtenstein,251093,3348678,-3097585,LIE
2009,ltu,Lituania,0,54860,-54860,LTU
2009,lux,Luxemburgo,0,3493,-3493,LUX
2009,lva,Letonia,0,218,-218,LVA
2009,mco,Mónaco,0,305,-305,MCO
2009,mlt,Malta,0,86,-86,MLT
2009,nld,Países Bajos,28894062,5263123,23630939,NLD
2009,nor,Noruega,1216041,642459,573582,NOR
2009,pol,Polonia,11844088,15524330,-3680242,POL
2009,prt,Portugal,268759,1861396,-1592637,PRT
2009,rou,Rumania,70076,6520833,-6450757,ROU
2009,rus,Rusia,852821,83450,769371,RUS
2009,smr,San Marino,0,114,-114,SMR
2009,svk,Eslovaquia,1909409,12320873,-10411464,SVK
2009,svn,Eslovenia,79441,895427,-815986,SVN
2009,swe,Suecia,5468122,55755874,-50287752,SWE
2009,ukr,Ucrania,845870,302997,542873,UKR
2009,vat,Ciudad del Vaticano,0,158,-158,VAT
2009,yug,Yugoslavia,0,104,-104,YUG
2009,abw,Aruba,121065,54609,66456,ABW
2009,atg,Antigua y Barbuda,32821,3420,29401,ATG
2009,blz,Belice,804578,1258,803320,BLZ
2009,brb,Barbados,238120,6000,232120,BRB
2009,can,Canadá,1571106147,882152953,688953194,CAN
2009,cri,Costa Rica,15682230,25153,15657077,CRI
2009,cub,Cuba,1756073,322,1755751,CUB
2009,dom,República Dominicana,7001162,10522,6990640,DOM
2009,gtm,Guatemala,13118133,217062,12901071,GTM
2009,hnd,Honduras,8926585,1021004,7905581,HND
2009,nic,Nicaragua,4078472,2628,4075844,NIC
2009,pan,Panamá,22171370,585833,21585537,PAN
2009,pri,Puerto Rico,30987223,217780,30769443,PRI
2009,slv,El Salvador,8717977,196,8717781,SLV
2009,tca,Turcas y Caicos,0,835,-835,TCA
2009,tto,Trinidad y Tobago,525804,19,525785,TTO
2009,usa,Estados Unidos,27097456972,5577710424,21519746548,USA
2009,aus,Australia,115485490,5238177,110247313,AUS
2009,cok,Islas Cook,0,48,-48,COK
2009,fji,Fiji,0,593,-593,FJI
2009,mhl,Islas Marshall,0,229,-229,MHL
2009,mnp,Islas Marianas del Norte,0,51,-51,MNP
2009,ncl,Nueva Caledonia,419607,473,419134,NCL
2009,nzl,Nueva Zelandia,1323246,67954,1255292,NZL
2009,png,Papua Nueva Guinea,0,295,-295,PNG
2009,tkl,Tokelau,0,47782,-47782,TKL
2009,ton,Tonga,0,17,-17,TON
2009,wlf,Wallis y Futuna,0,27,-27,WLF
2009,arg,Argentina,370778925,306537890,64241035,ARG
2009,bra,Brasil,930442932,937430549,-6987617,BRA
2009,chl,Chile,132324646,2186890,130137756,CHL
2009,col,Colombia,240496437,732792,239763645,COL
2009,ecu,Ecuador,62448549,1494,62447055,ECU
2009,per,Perú,56436876,34666,56402210,PER
2009,ury,Uruguay,38175357,375147,37800210,URY
2009,ven,Venezuela,34878954,1821806,33057148,VEN
2009,dza,Argelia,10564980,0,10564980,DZA
2009,eri,Eritrea,341682,0,341682,ERI
2009,moz,Mozambique,113426,0,113426,MOZ
2009,bhr,Bahrein,12829,0,12829,BHR
2009,brn,Brunéi,126035,0,126035,BRN
2009,cyp,Chipre,207466,0,207466,CYP
2009,lbn,Líbano,116732,0,116732,LBN
2009,mng,Mongolia,398828,0,398828,MNG
2009,qat,Katar,3716,0,3716,QAT
2009,isl,Islandia,3699,0,3699,ISL
2009,bhs,Las Bahamas,137487,0,137487,BHS
2009,bmu,Bermuda,46081,0,46081,BMU
2009,cuw,Curaçao,181359,0,181359,CUW
2009,cym,Islas Caimán,142038,0,142038,CYM
2009,grd,Granada,10654,0,10654,GRD
2009,hti,Haití,536488,0,536488,HTI
2009,jam,Jamaica,788937,0,788937,JAM
2009,lca,Santa Lucía,20044,0,20044,LCA
2009,vct,San Vicente y las Granadinas,1005,0,1005,VCT
2009,glp,Guadalupe,2558,0,2558,GLP
2009,bol,Bolivia,3848670,0,3848670,BOL
2009,guy,Guayana,13290,0,13290,GUY
2009,pry,Paraguay,1513412,0,1513412,PRY
2009,sur,Suriname,1291,0,1291,SUR
2008,bfa,Burkina Faso,0,192,-192,BFA
2008,caf,República Centroafricana,0,114,-114,CAF
2008,civ,Côte d'Ivoire,210000,211,209789,CIV
2008,cmr,Camerún,0,1184,-1184,CMR
2008,cog,"Congo, República del",122943,147,122796,COG
2008,com,Comoras,0,91,-91,COM
2008,dza,Argelia,256615,113,256502,DZA
2008,egy,Egipto,442844,61017,381827,EGY
2008,eth,Etiopía,0,50,-50,ETH
2008,gmb,Gambia,0,8,-8,GMB
2008,mar,Marruecos,0,8683,-8683,MAR
2008,mli,Malí,0,952,-952,MLI
2008,moz,Mozambique,0,2403,-2403,MOZ
2008,mus,Mauricio,0,320,-320,MUS
2008,mwi,Malawi,0,174,-174,MWI
2008,nam,Namibia,0,107,-107,NAM
2008,ner,Níger,0,11,-11,NER
2008,nga,Nigeria,0,7316,-7316,NGA
2008,reu,Réunion,0,919,-919,REU
2008,rwa,Ruanda,0,125,-125,RWA
2008,sdn,Sudán,200000,33,199967,SDN
2008,sen,Senegal,0,25468,-25468,SEN
2008,som,Somalia,0,18836,-18836,SOM
2008,swz,Esuatini,0,1679,-1679,SWZ
2008,tcd,Chad,0,11,-11,TCD
2008,tgo,Togo,0,594,-594,TGO
2008,tun,Túnez,263763,2585,261178,TUN
2008,uga,Uganda,46837,9,46828,UGA
2008,zaf,Sudáfrica,82320863,10561288,71759575,ZAF
2008,zmb,Zambia,0,2631,-2631,ZMB
2008,zwe,Zimbabue,0,50,-50,ZWE
2008,afg,Afganistán,0,3325,-3325,AFG
2008,are,Emiratos Árabes Unidos,1744048,5335,1738713,ARE
2008,bhr,Bahrein,0,56,-56,BHR
2008,chn,China,180817271,691459985,-510642714,CHN
2008,geo,Georgia,62000,2174,59826,GEO
2008,hkg,Hong Kong,1339020,546315,792705,HKG
2008,idn,Indonesia,7422646,42411367,-34988721,IDN
2008,ind,India,31601881,164859990,-133258109,IND
2008,iot,Territorio Británico del Océano Índico,18606,35207,-16601,IOT
2008,irn,Irán,0,40,-40,IRN
2008,isr,Israel,60498969,251365,60247604,ISR
2008,jor,Jordania,0,16,-16,JOR
2008,jpn,Japón,271059978,2180938605,-1909878627,JPN
2008,kaz,Kazajstán,0,11,-11,KAZ
2008,kgz,Kirguistán,0,2959,-2959,KGZ
2008,khm,Camboya,0,175,-175,KHM
2008,kor,Corea del Sur,14922434,623513154,-608590720,KOR
2008,lbn,Líbano,0,131,-131,LBN
2008,lka,Sri Lanka,129525,188679,-59154,LKA
2008,mac,Macau,0,9643,-9643,MAC
2008,mmr,Birmania,0,165,-165,MMR
2008,mys,Malasia,6152203,3540909,2611294,MYS
2008,npl,Nepal,0,14,-14,NPL
2008,pak,Pakistán,41139,178365,-137226,PAK
2008,phl,Filipinas,1185732,1559327,-373595,PHL
2008,prk,Corea del Norte,0,72480,-72480,PRK
2008,sau,Arabia Saudita,1373585,6519,1367066,SAU
2008,sgp,Singapur,7799341,3174844,4624497,SGP
2008,syr,Siria,0,184,-184,SYR
2008,tha,Tailandia,23253964,54907327,-31653363,THA
2008,tur,Turquía,167595,56448725,-56281130,TUR
2008,twn,Taiwan,10493106,146918865,-136425759,TWN
2008,uzb,Uzbekistán,0,4635,-4635,UZB
2008,vnm,Vietnam,127263,2022870,-1895607,VNM
2008,alb,Albania,0,5435,-5435,ALB
2008,ant,Antillas Holandesas,237847,580,237267,ANT
2008,aut,Austria,1086619,25710619,-24624000,AUT
2008,bel,Bélgica,13641819,49492311,-35850492,BEL
2008,bgr,Bulgaria,1038,9129,-8091,BGR
2008,bih,Bosnia y Herzegovina,0,640,-640,BIH
2008,blr,Bielorrusia,0,22715,-22715,BLR
2008,che,Suiza,24322087,1181393,23140694,CHE
2008,cze,Chequia,5328056,22102649,-16774593,CZE
2008,deu,Alemania,3445841048,1450028502,1995812546,DEU
2008,dnk,Dinamarca,111067,1065316,-954249,DNK
2008,emu,Comunidad Europea,153688467,625428,153063039,EMU
2008,esp,España,13176305,368885855,-355709550,ESP
2008,est,Estonia,401572,152261,249311,EST
2008,fin,Finlandia,18966611,1097487,17869124,FIN
2008,fra,Francia,14137618,163119960,-148982342,FRA
2008,gbr,Reino Unido,25998414,230793846,-204795432,GBR
2008,gib,Gibraltar,0,679,-679,GIB
2008,grc,Grecia,0,22756,-22756,GRC
2008,hrv,Croacia,1554149,146140,1408009,HRV
2008,hun,Hungría,305858,19896259,-19590401,HUN
2008,irl,Irlanda,20016,455320,-435304,IRL
2008,isl,Islandia,1327100,1259,1325841,ISL
2008,ita,Italia,18835987,127242014,-108406027,ITA
2008,lie,Liechtenstein,19258,4938144,-4918886,LIE
2008,ltu,Lituania,0,518,-518,LTU
2008,lux,Luxemburgo,0,3522,-3522,LUX
2008,mco,Mónaco,0,3161,-3161,MCO
2008,mkd,Macedonia del Norte,0,185,-185,MKD
2008,mlt,Malta,0,176,-176,MLT
2008,nld,Países Bajos,241313864,8879735,232434129,NLD
2008,nor,Noruega,332785,931973,-599188,NOR
2008,pol,Polonia,21884408,19866032,2018376,POL
2008,prt,Portugal,1525510,7501746,-5976236,PRT
2008,rou,Rumania,300,5409012,-5408712,ROU
2008,rus,Rusia,58915780,53682,58862098,RUS
2008,svk,Eslovaquia,960179,31206324,-30246145,SVK
2008,svn,Eslovenia,197464,3165525,-2968061,SVN
2008,swe,Suecia,9312226,89466712,-80154486,SWE
2008,ukr,Ucrania,6369931,27705,6342226,UKR
2008,abw,Aruba,919278,218413,700865,ABW
2008,aia,Anguilla,0,17542,-17542,AIA
2008,atg,Antigua y Barbuda,27825,492,27333,ATG
2008,bhs,Las Bahamas,1101276,70125,1031151,BHS
2008,blz,Belice,1567722,628,1567094,BLZ
2008,brb,Barbados,281271,27237,254034,BRB
2008,can,Canadá,1544757720,1340691814,204065906,CAN
2008,cri,Costa Rica,46148451,52101,46096350,CRI
2008,dom,República Dominicana,12245048,56827,12188221,DOM
2008,gtm,Guatemala,32953915,939286,32014629,GTM
2008,hnd,Honduras,18793222,2701467,16091755,HND
2008,hti,Haití,545966,172417,373549,HTI
2008,jam,Jamaica,823597,43,823554,JAM
2008,nic,Nicaragua,14277625,2249,14275376,NIC
2008,pan,Panamá,50929200,23382,50905818,PAN
2008,pri,Puerto Rico,25954249,1441856,24512393,PRI
2008,slv,El Salvador,9848279,7367,9840912,SLV
2008,tca,Turcas y Caicos,0,3657,-3657,TCA
2008,tto,Trinidad y Tobago,492485,139,492346,TTO
2008,usa,Estados Unidos,32829216513,9245033015,23584183498,USA
2008,vct,San Vicente y las Granadinas,4090,1738,2352,VCT
2008,vgb,Islas Vírgenes Británicas,0,65275,-65275,VGB
2008,vir,Islas Vírgenes,0,43,-43,VIR
2008,aus,Australia,154349956,6343108,148006848,AUS
2008,cok,Islas Cook,0,325,-325,COK
2008,kir,Kiribati,0,798,-798,KIR
2008,mhl,Islas Marshall,0,188,-188,MHL
2008,ncl,Nueva Caledonia,0,254,-254,NCL
2008,nfk,Isla Norfolk,0,14,-14,NFK
2008,nru,Nauru,0,14,-14,NRU
2008,nzl,Nueva Zelandia,1740937,171167,1569770,NZL
2008,plw,Palau,0,30154,-30154,PLW
2008,png,Papua Nueva Guinea,207049,205,206844,PNG
2008,slb,Islas Salomón,0,2444,-2444,SLB
2008,tkl,Tokelau,0,17036,-17036,TKL
2008,wsm,Samoa,0,32,-32,WSM
2008,arg,Argentina,429381130,466293488,-36912358,ARG
2008,bol,Bolivia,6671414,75,6671339,BOL
2008,bra,Brasil,1516070346,1350547712,165522634,BRA
2008,chl,Chile,193607986,7857109,185750877,CHL
2008,col,Colombia,400975443,2124876,398850567,COL
2008,ecu,Ecuador,93241703,3600,93238103,ECU
2008,per,Perú,344497373,253086,344244287,PER
2008,ury,Uruguay,71584916,7220696,64364220,URY
2008,ven,Venezuela,177805184,9684347,168120837,VEN
2008,guf,Guayana Francesa,122714,9,122705,GUF
2008,ago,Angola,41348,0,41348,AGO
2008,ken,Kenia,129529,0,129529,KEN
2008,tza,Tanzania,41050,0,41050,TZA
2008,brn,Brunéi,418590,0,418590,BRN
2008,cyp,Chipre,50978,0,50978,CYP
2008,tmp,Timor Oriental,129525,0,129525,TMP
2008,bmu,Bermuda,51001,0,51001,BMU
2008,cub,Cuba,1521936,0,1521936,CUB
2008,cuw,Curaçao,749797,0,749797,CUW
2008,cym,Islas Caimán,180251,0,180251,CYM
2008,dma,Dominica,199932,0,199932,DMA
2008,grd,Granada,8976,0,8976,GRD
2008,lca,Santa Lucía,1793,0,1793,LCA
2008,glp,Guadalupe,519,0,519,GLP
2008,mtq,Martinica,73466,0,73466,MTQ
2008,pyf,Polinesia francés,170577,0,170577,PYF
2008,guy,Guayana,47323,0,47323,GUY
2008,pry,Paraguay,34592117,0,34592117,PRY
2007,egy,Egipto,2706889,0,2706889,EGY
2007,esh,Sahara Occidental,41116,0,41116,ESH
2007,lby,Libia,40921688,0,40921688,LBY
2007,swz,Esuatini,388,0,388,SWZ
2007,uga,Uganda,38094,0,38094,UGA
2007,zaf,Sudáfrica,44510267,0,44510267,ZAF
2007,are,Emiratos Árabes Unidos,893821,0,893821,ARE
2007,brn,Brunéi,326743,0,326743,BRN
2007,chn,China,211986620,0,211986620,CHN
2007,cyp,Chipre,250741,0,250741,CYP
2007,hkg,Hong Kong,4446386,0,4446386,HKG
2007,idn,Indonesia,4015485,0,4015485,IDN
2007,ind,India,1799834,0,1799834,IND
2007,isr,Israel,12682697,0,12682697,ISR
2007,jpn,Japón,304475174,0,304475174,JPN
2007,kor,Corea del Sur,16814853,0,16814853,KOR
2007,kwt,Kuwait,437540,0,437540,KWT
2007,lbn,Líbano,492,0,492,LBN
2007,lka,Sri Lanka,1170,0,1170,LKA
2007,mys,Malasia,7046423,0,7046423,MYS
2007,phl,Filipinas,74772,0,74772,PHL
2007,prk,Corea del Norte,29720,0,29720,PRK
2007,qat,Katar,7710,0,7710,QAT
2007,sau,Arabia Saudita,1015847,0,1015847,SAU
2007,sgp,Singapur,5434046,0,5434046,SGP
2007,tha,Tailandia,22082221,0,22082221,THA
2007,tur,Turquía,3242144,0,3242144,TUR
2007,twn,Taiwan,7681184,0,7681184,TWN
2007,vnm,Vietnam,800843,0,800843,VNM
2007,ant,Antillas Holandesas,1264782,0,1264782,ANT
2007,aut,Austria,4176810,0,4176810,AUT
2007,bel,Bélgica,4702588,0,4702588,BEL
2007,bgr,Bulgaria,5760,0,5760,BGR
2007,che,Suiza,7122831,0,7122831,CHE
2007,cze,Chequia,4443593,0,4443593,CZE
2007,deu,Alemania,2729923333,0,2729923333,DEU
2007,dnk,Dinamarca,52162,0,52162,DNK
2007,emu,Comunidad Europea,177828299,0,177828299,EMU
2007,esp,España,16755897,0,16755897,ESP
2007,est,Estonia,167000,0,167000,EST
2007,fin,Finlandia,3974115,0,3974115,FIN
2007,fra,Francia,12664962,0,12664962,FRA
2007,gbr,Reino Unido,40584129,0,40584129,GBR
2007,grc,Grecia,1931685,0,1931685,GRC
2007,hrv,Croacia,564384,0,564384,HRV
2007,hun,Hungría,9980021,0,9980021,HUN
2007,irl,Irlanda,126080,0,126080,IRL
2007,ita,Italia,16572283,0,16572283,ITA
2007,lie,Liechtenstein,7752,0,7752,LIE
2007,lux,Luxemburgo,2669,0,2669,LUX
2007,nld,Países Bajos,13230615,0,13230615,NLD
2007,nor,Noruega,988966,0,988966,NOR
2007,pol,Polonia,8879131,0,8879131,POL
2007,prt,Portugal,1637835,0,1637835,PRT
2007,rou,Rumania,41798,0,41798,ROU
2007,rus,Rusia,119914021,0,119914021,RUS
2007,svk,Eslovaquia,264115,0,264115,SVK
2007,svn,Eslovenia,3379897,0,3379897,SVN
2007,swe,Suecia,4763689,0,4763689,SWE
2007,ukr,Ucrania,7395386,0,7395386,UKR
2007,yug,Yugoslavia,48613,0,48613,YUG
2007,abw,Aruba,494433,0,494433,ABW
2007,bhs,Las Bahamas,1281435,0,1281435,BHS
2007,blz,Belice,4822596,0,4822596,BLZ
2007,bmu,Bermuda,57866,0,57866,BMU
2007,brb,Barbados,556098,0,556098,BRB
2007,can,Canadá,1408800869,0,1408800869,CAN
2007,cri,Costa Rica,30957694,0,30957694,CRI
2007,cub,Cuba,1127998,0,1127998,CUB
2007,cuw,Curaçao,308435,0,308435,CUW
2007,cym,Islas Caimán,268803,0,268803,CYM
2007,dom,República Dominicana,15476231,0,15476231,DOM
2007,grd,Granada,12566,0,12566,GRD
2007,gtm,Guatemala,26665299,0,26665299,GTM
2007,hnd,Honduras,11472126,0,11472126,HND
2007,hti,Haití,746692,0,746692,HTI
2007,jam,Jamaica,454734,0,454734,JAM
2007,lca,Santa Lucía,7215,0,7215,LCA
2007,nic,Nicaragua,9636739,0,9636739,NIC
2007,pan,Panamá,28012226,0,28012226,PAN
2007,pri,Puerto Rico,28166203,0,28166203,PRI
2007,slv,El Salvador,12057087,0,12057087,SLV
2007,tto,Trinidad y Tobago,535814,0,535814,TTO
2007,usa,Estados Unidos,33588404137,0,33588404137,USA
2007,vct,San Vicente y las Granadinas,1205,0,1205,VCT
2007,aus,Australia,161761210,0,161761210,AUS
2007,ncl,Nueva Caledonia,50128,0,50128,NCL
2007,nzl,Nueva Zelandia,1906794,0,1906794,NZL
2007,arg,Argentina,232054183,0,232054183,ARG
2007,bol,Bolivia,2802813,0,2802813,BOL
2007,bra,Brasil,692754904,0,692754904,BRA
2007,chl,Chile,169907856,0,169907856,CHL
2007,col,Colombia,698034486,0,698034486,COL
2007,ecu,Ecuador,32742344,0,32742344,ECU
2007,guy,Guayana,58956,0,58956,GUY
2007,per,Perú,74275401,0,74275401,PER
2007,pry,Paraguay,17489200,0,17489200,PRY
2007,sur,Suriname,1967,0,1967,SUR
2007,ury,Uruguay,16637151,0,16637151,URY
2007,ven,Venezuela,718850372,0,718850372,VEN
2007,guf,Guayana Francesa,260276,0,260276,GUF
2006,ago,Angola,0,851,-851,AGO
2006,ben,Benin,0,273,-273,BEN
2006,bfa,Burkina Faso,0,137,-137,BFA
2006,caf,República Centroafricana,0,48,-48,CAF
2006,cmr,Camerún,0,2147,-2147,CMR
2006,cog,"Congo, República del",0,19,-19,COG
2006,com,Comoras,0,487,-487,COM
2006,dza,Argelia,0,44,-44,DZA
2006,egy,Egipto,1758694,509,1758185,EGY
2006,eth,Etiopía,0,130,-130,ETH
2006,gab,Gabón,0,12,-12,GAB
2006,gha,Ghana,0,975,-975,GHA
2006,gnb,Guinea-Bissau,0,280,-280,GNB
2006,ken,Kenia,6246,455,5791,KEN
2006,mar,Marruecos,315259,15266,299993,MAR
2006,mus,Mauricio,282,2030,-1748,MUS
2006,nam,Namibia,0,1428,-1428,NAM
2006,ner,Níger,154603,449,154154,NER
2006,nga,Nigeria,412552,999,411553,NGA
2006,reu,Réunion,0,5,-5,REU
2006,sen,Senegal,0,2656,-2656,SEN
2006,swz,Esuatini,0,1179,-1179,SWZ
2006,tcd,Chad,0,75,-75,TCD
2006,tun,Túnez,562561,2372,560189,TUN
2006,tza,Tanzania,0,114,-114,TZA
2006,uga,Uganda,0,21,-21,UGA
2006,zaf,Sudáfrica,56938640,6182929,50755711,ZAF
2006,afg,Afganistán,63461,289,63172,AFG
2006,are,Emiratos Árabes Unidos,286392,560,285832,ARE
2006,arm,Armenia,0,117,-117,ARM
2006,bgd,Bangladesh,0,98,-98,BGD
2006,chn,China,199436941,475370327,-275933386,CHN
2006,cyp,Chipre,99160,104562,-5402,CYP
2006,geo,Georgia,0,2514,-2514,GEO
2006,hkg,Hong Kong,2823567,1665901,1157666,HKG
2006,idn,Indonesia,1361182,3189068,-1827886,IDN
2006,ind,India,657007,148343389,-147686382,IND
2006,irn,Irán,15083,442,14641,IRN
2006,isr,Israel,2223821,279472,1944349,ISR
2006,jpn,Japón,279576734,1838147367,-1558570633,JPN
2006,khm,Camboya,0,24,-24,KHM
2006,kor,Corea del Sur,18657759,427925993,-409268234,KOR
2006,lbn,Líbano,1547,561,986,LBN
2006,lka,Sri Lanka,37681,77277,-39596,LKA
2006,mdv,Maldivas,0,75,-75,MDV
2006,mys,Malasia,2361028,12037321,-9676293,MYS
2006,npl,Nepal,0,183,-183,NPL
2006,pak,Pakistán,379686,320590,59096,PAK
2006,phl,Filipinas,212042,3539084,-3327042,PHL
2006,prk,Corea del Norte,8978,314848,-305870,PRK
2006,sau,Arabia Saudita,327663,2025,325638,SAU
2006,sgp,Singapur,2456935,3119691,-662756,SGP
2006,tha,Tailandia,19378527,21614882,-2236355,THA
2006,tjk,Tayikistán,0,174,-174,TJK
2006,tur,Turquía,11622094,58945321,-47323227,TUR
2006,twn,Taiwan,16178061,90708601,-74530540,TWN
2006,vnm,Vietnam,4215,987044,-982829,VNM
2006,ant,Antillas Holandesas,487660,4344,483316,ANT
2006,aut,Austria,918887,24826527,-23907640,AUT
2006,bel,Bélgica,3179568,83960811,-80781243,BEL
2006,bgr,Bulgaria,15148,17849,-2701,BGR
2006,bih,Bosnia y Herzegovina,0,3946,-3946,BIH
2006,blr,Bielorrusia,1598,197089,-195491,BLR
2006,che,Suiza,2542856,2211688,331168,CHE
2006,cze,Chequia,4803698,7801766,-2998068,CZE
2006,deu,Alemania,1691222770,1217790034,473432736,DEU
2006,dnk,Dinamarca,267449,1397825,-1130376,DNK
2006,emu,Comunidad Europea,54603,817224,-762621,EMU
2006,esp,España,7892689,333957185,-326064496,ESP
2006,est,Estonia,10043,32342,-22299,EST
2006,fin,Finlandia,22156,1058912,-1036756,FIN
2006,fra,Francia,8289724,177138493,-168848769,FRA
2006,gbr,Reino Unido,39824125,170224231,-130400106,GBR
2006,gib,Gibraltar,0,110,-110,GIB
2006,grc,Grecia,116954,24093,92861,GRC
2006,hrv,Croacia,12500,2192,10308,HRV
2006,hun,Hungría,2335112,14177747,-11842635,HUN
2006,irl,Irlanda,429381,257217,172164,IRL
2006,isl,Islandia,0,581,-581,ISL
2006,ita,Italia,3776221,63200233,-59424012,ITA
2006,lie,Liechtenstein,10316,16385915,-16375599,LIE
2006,ltu,Lituania,0,3319,-3319,LTU
2006,lux,Luxemburgo,5890,2260,3630,LUX
2006,lva,Letonia,0,544,-544,LVA
2006,mco,Mónaco,0,9497,-9497,MCO
2006,mlt,Malta,40112,201,39911,MLT
2006,nld,Países Bajos,5262352,7954278,-2691926,NLD
2006,nor,Noruega,0,614661,-614661,NOR
2006,pol,Polonia,1646030,7347213,-5701183,POL
2006,prt,Portugal,884209,6944228,-6060019,PRT
2006,rou,Rumania,0,2693651,-2693651,ROU
2006,rus,Rusia,430080,2884832,-2454752,RUS
2006,svk,Eslovaquia,426835,21324869,-20898034,SVK
2006,svn,Eslovenia,126553,4218564,-4092011,SVN
2006,swe,Suecia,2416814,97333579,-94916765,SWE
2006,ukr,Ucrania,0,49643,-49643,UKR
2006,yug,Yugoslavia,0,3339,-3339,YUG
2006,abw,Aruba,2185030,13888,2171142,ABW
2006,atg,Antigua y Barbuda,0,342,-342,ATG
2006,blz,Belice,2476630,12568,2464062,BLZ
2006,can,Canadá,1163034338,1454082715,-291048377,CAN
2006,cri,Costa Rica,9557487,14067,9543420,CRI
2006,cub,Cuba,2167367,3862,2163505,CUB
2006,dom,República Dominicana,12573060,67755,12505305,DOM
2006,grd,Granada,0,248,-248,GRD
2006,gtm,Guatemala,21529886,77994,21451892,GTM
2006,hnd,Honduras,9297592,4772557,4525035,HND
2006,hti,Haití,621186,85252,535934,HTI
2006,jam,Jamaica,465214,954,464260,JAM
2006,msr,Montserrat,0,15,-15,MSR
2006,nic,Nicaragua,5189656,386,5189270,NIC
2006,pan,Panamá,13984315,79890,13904425,PAN
2006,pri,Puerto Rico,38981290,197692,38783598,PRI
2006,slv,El Salvador,9061145,11089,9050056,SLV
2006,tto,Trinidad y Tobago,1230229,5597,1224632,TTO
2006,usa,Estados Unidos,34067297987,8980707515,25086590472,USA
2006,vir,Islas Vírgenes,0,5049,-5049,VIR
2006,aus,Australia,153263075,3085550,150177525,AUS
2006,fji,Fiji,0,250,-250,FJI
2006,kir,Kiribati,0,28,-28,KIR
2006,ncl,Nueva Caledonia,36406,267,36139,NCL
2006,nfk,Isla Norfolk,0,285,-285,NFK
2006,nzl,Nueva Zelandia,4654177,60046,4594131,NZL
2006,arg,Argentina,192844220,540102841,-347258621,ARG
2006,bol,Bolivia,1021040,18427,1002613,BOL
2006,bra,Brasil,360348446,2027051485,-1666703039,BRA
2006,chl,Chile,131615689,12710117,118905572,CHL
2006,col,Colombia,449242519,1862322,447380197,COL
2006,ecu,Ecuador,27670973,811,27670162,ECU
2006,guy,Guayana,0,11,-11,GUY
2006,per,Perú,24711992,38188,24673804,PER
2006,ury,Uruguay,4728511,526735,4201776,URY
2006,ven,Venezuela,346971217,10680289,336290928,VEN
2006,lby,Libia,2605195,0,2605195,LBY
2006,brn,Brunéi,249976,0,249976,BRN
2006,irq,Irak,113712,0,113712,IRQ
2006,jor,Jordania,19563,0,19563,JOR
2006,kaz,Kazajstán,38506,0,38506,KAZ
2006,kwt,Kuwait,287528,0,287528,KWT
2006,bhs,Las Bahamas,1701187,0,1701187,BHS
2006,bmu,Bermuda,35392,0,35392,BMU
2006,brb,Barbados,459456,0,459456,BRB
2006,cuw,Curaçao,1145571,0,1145571,CUW
2006,cym,Islas Caimán,4528445,0,4528445,CYM
2006,dma,Dominica,247800,0,247800,DMA
2006,lca,Santa Lucía,2585,0,2585,LCA
2006,vct,San Vicente y las Granadinas,2869,0,2869,VCT
2006,fsm,Micronesia,25984,0,25984,FSM
2006,pry,Paraguay,3193899,0,3193899,PRY
2006,sur,Suriname,1105,0,1105,SUR